AdminPartners=Brugere
Login=Log Ind
RequestLogin=Venligst log ind
UserName=Brugernavn:
Password=Adgangskode:
PasswordChangeTitle=Skift adgangskode
cancelKey=Annuller
GenerateGraph=Tegn Graf
Symbol=Symbol:
TimeFrame=Tidshorisont
FromDate=Fra Dato:
ToDate=Til Dato:
EndDate=Slutdato:
SelectLastDate=Vælg første eller sidste dag for grafen
AddIndicator=Tilføj Indikator
SelectIndicator=Vælg Indikator
ChooseSymbols=Vælg Symboler:
ChooseIndicatorParameter=Vælg Indikator Parametre
UpdateGraph=Opdater Grafen
BackToChart=Tilbage til grafen
Compare=SammenlignSammenlign
ViewGraph=Se Graf
SuperTrader=Super Trader
Copyright=©2010 Straticator. All Rights Reserved
ShowGraph=Vis Graf
ShowValues=Vis Værdier
BackToStrategie=Tilbage Til Strategi
CustomIndicator=Brugerdefineret Indikator
Trading=Handel
MyAccount=Min Konto
SymbolCollections=Mine Symboler
RunningRobots=Robot Status
Reports=Rapporter
OK=OK
SetAsDefault=Sæt Som Udgangspunkt
Reset=Nulstil
Apply=Anvend
Name=Navn
LastEdited=Senest Ændret
Owner=Ejer
CreateIndicator=Opret Indikator
EditCustomIndicator=Ret Brugerdefineret Indikator
CreateCustomIndicator=Opret Brugerdefineret Indikator
Indicator=Indikator
GoToDate=Gå Til Dato
Result=Resultat:
SShared=Delt:
UserID=Bruger ID:
CodeName=Navn:
ParameterNumber=Antal Parametre:
Print=Print
IndicatorType=Indikator Type:
Simple=Simpel
Complex=Kompleks
ReturnValueCount=Antal Grafer:
BuildTrader=Opret Eller Ændre Trader
TestTrader=Test Trader
RunTrader=Kør Eller Test Trader
Indicators=Indikatorer
IndicatorName=Indikator Navn:
AddParam=Tilføj Parametre
ShowHistory=Vis Historik
AddIndicators=Tilføj Indikator
AddRobot=Tilføj Robot
ParamsAddedSuccessMsg=Parametre Tilføjet
Parameters=Parametre
View=View
Visible=Synlig
ShowDelta=Vis Delta
Color=Farve
UpdateView=Opdater
Prev===<<Forrige
Next=Næste>>
WorkingPrice=Gældende Pris:
GraphView=Graf Udseende:
GraphType=Graf Type:
Finish=Afslut
GraphAppearance=Graf Udtryk
Edit=Ændre
Delete=Slet
DeleteConfirmation=Er du sikker på du vil slette?
CandleStickChartHeader=Candlestick Graf
IndicatorChartHeader=Indikator Graf
CandleStick=Candlestick
CollapseAll=Luk Alt
ExpandAll=Udvid Alt
DesignGraph=DESIGN GRAF
CreateStrategie=Opret Strategi
ViewBackTestResult=Backtest Resultat
Save=Gem
TradingStrategie=Handelsstrategi
BackToIndicators=Tilbage Til Indikatorer
AddExpressions=Tilføj Udtryk
TradeExpressions=Handels Udtryk
RobotInputs=Input
RobotHasOpenPosition=Robotten har en åben position.
Compile=Indsamle
EnterLong=Åben Lang
EnterShort=Åben Kort
ExitLong=Luk Lang
ExitShort=Luk Kort
VolumeCheckMsg=Volumen skal være større end 0
ChooseValidDateMsg=Vælg venligst en valid dato
ErrorInexpressionMsg=Fejl "{0}" i {1} expression#near token '{2}'#i linie {3} på position: {4}
CompilationSuccessMsg=Indsamling vellykket.#Resultat for Indsamling: # 
Value=Værdi:
Period=Perioder:
NoOfPeriod=Antal af Perioder:
Delta=Delta:
Price=Pris:
SelectSymbol=Vælg Symbol:
SelectAnIndicator=Vælg en Indikator:
SelectGraph=Vælg Graf:
TextBoxEmptyMsg=Feltet skal udfyldes
ComboBoxEmptyMsg=Vælg en værdi
TradingStrategies=Handelsstrategier
TradingExpression=Handelsudtryk
TradeId=Handels ID
CreatedOn=Oprettet den 
Clear=Slet
Comments=Forklaring
TShared=Delt
SaveTrader=Gem Trader
SaveAs=Gem Som...
New=Ny
TextBoxNonNegativeMsg=Værdi kan ikke være mindre end 0
Wizard=Wizard
Add=Tilføj
AddSymbol=Tilføj Symbol
DeleteSymbol=Slet Symbol
Comment=Kommentar:
SSelect=Vælg
SharedInfo=Delte Elementer
SharedToOther=Jeg Deler Med Andre
SharedByOther=Delt Af Andre
SUserName=Brugernavn:
SIndicators=Indikator:
STraders=Strategier:
STrading=Handel:
SAccount=Konto:
SSearchUser=Søg Bruger
AddUser=Opret Bruger
SValidateUser=Vælg en valid bruger.
SVSharedInfo=Login Id allerede delt af dig
STabFrom=Delt Fra
STabTo=Delt Til 
SearchUserName=Søg Brugernavn:
Searchkey=Søg
SearchValidate=Udfyld venligst felterne før søgning
SearchResult=Intet fundet - Prøv igen
MyTradingStrategies=Mine Handelsstrategier
TradingStrategiesSharedByOther=Handelsstrategier Delt Med Andre 
BackTest=Backtest
MPTitle=Markedspris
MPSymbol=Symbol:
MPVolume=Volumen:
MPStopLoss=Stop Loss (pips):
MPTProfit=Take Profit (pips):
MPTrack=Spor:
MPType=Ordretype:
MPIExecution=Hurtig Eksekvering
MPSell=SÆLG
MPBuy=KØB
MPQuoPrice=Aktiver maksimum afvigelse fra anførte pris
MPMDeviation=Maksimum Afvigelse
MPLTrader=Seneste Handler:
MPDuration=Varighed:
MPSlipp=Slippage (pips):
MPPrice=Pris:
MPClose=Lukke
FVTrade=Handel
ODPrint=Print
ODExport=Eksporter til Excel
TAUid=Brugernavn:
TAName=Navn:
TAPassword=Adgangskode:
TARePassword=Gentag Adgangskode:
TANew=Ny
TAEdit=Ændre
TAId=ID
TAUName=Brugernavn:
RORefresh=Opdater
Export=Eksporter
CreateRobot=Opret Robot
TerminateStrategie=Slet Strategi:
Expiration=Udløb:
Started=Started
Stopped=Stoppet
LastTrade=Sidste Handel
HasLongPosition=Har Lang Position
HasShortPosition=Har Kort Position
ResetWhenStarted=Nulstil Ved Start:
Volume=Volumen:
StopLoss=Maks. Tab:
TakeProfit=Indtjent Profit:
StopRobotAfter=Stop Robot Efter:
StopCriteria=Stop Kriterie:
StartRobot=Start Robot
ShortTrack=Kort Spor:
LongTrack=Langt Spor:
Trackkey=Spor
Account=Konto
TradeIdColon=Handels ID:
TimeframeColon=Tidsramme:
TradingParameters=Handelsparametre: 
ExitCriteriaforTrade=Kriterier for lukning af Position:
ExitCriteriaforRobot=Slet Kriterie for Robot:
StopRobot=Stop Robot
ClearHistory=Forbered Genstart
CommentsColon=Forklaring:
EditParameters=Ændre Parametre
mLoggedin=Antal Brugere Logget Ind:
mRobots=Antal Aktive Robotter:
mStopRobots=Stop alle robotter
mStartRobots=Start alle robotter
mDataConnection=Tjek forbindelse til database:
mConnection=Opret forbindelse til database
mPriceFeed=Tjek om Price Feed kører:
mcPriceFeed=Opret forbindelse til Price Feed Server
mCommand=Kommando:
mLoxoCommand=Kommando
mResult=Resultat:
Back=Tilbage
Performance=Opnået Resultat
Transactions=Transaktioner
Summary=Resumé
ConvertToStrategie=Konverter til Strategi
OptimizeParameters=Optimer Parametre
ViewParameters=Se Parametre
FetchingData=Henter Data...
SaveCustomer=Gem
CancelCustomer=Annuller
NotificationKey=Notifikationer
ViewTrackingKey=Se Spor 
UserAccountKey=Se Brugerkonto
UserId=Bruger ID:
GroupName=Gruppenavn:
BusyMessage=Vent venligst...
NewCustomerCreating=En ny kunde bliver oprettet. Vent venligst…
CustomerLink=Venligt forbind en bruger til denne kunde.
RobotTerminationkey=Slet alle robotter
StopLossBankKey=Stop outcall fra banken
ValVolumne=Venligst indtast volumen større end nul.
ValPrice=Venligst indtast pris.
ValId=Id felt må ikke være blankt.
ValName=Navne felt må ikke være blankt.
ValNoParam=Felt med antal parametre skal udfyldes.
ValComment=Kommentar er et obligatorisk felt.
ValNoGraphs=Felt med antal grafer skal udfyldes.
ValIndicatoreSave=Indikator er ikke gemt.
ValDuplicate=Dupliker Kode ID.
ValCompile=Succesfuldt indsamlet.
ValNumber=Numre ikke tilladt.
VAccountNo=Felt med kontonummer skal udfyldes.
VMSAccount=Felt med konto skal udfyldes.
VAccountNoDuplicate=Ingen duplikerede kontonumre.
VCurrency=Valuta er et obligatorisk felt.
ValTrack=Spor skal være større end 0.
BackTestAgain=Backtest Igen
Exit=Afslut
ParameterspastedMsg=Parametre succesfuldt indsat.
NoResultMsg=Intet fundet.
PasteTraderValue=Indsæt værdi i trader
BackTestResult=Backtest Resultat
BTInProcess=Backtest behandles.
NoOfCandleStick=Antallet af Candlestick
NoOfCombinationsFinished=Antallet af Kombinationer Afsluttet
TotalCombinations=Totals Antal Kombinationer
EstimatedTimeLeft=Estimeret Tid Tilbage
TestForComplete=Test For at Færdiggøre
CancelBackTest=Annuller Backtest
BackTestCancelledMsg=Backtest Annulleret
Wait=Vent i {0} sekunder.
LongShortExpressionRequiredMsg=Venligst indtast handelsstrategi. Indtast enten et Langt eller Kort udtryk.
ParameterRequiredMsg=Vælg mindst ét parametre.
Test=Test
ExpressionParameters=Udtryk Parametre
LoopNo:===Loop Nummer:
Profit:===Profit (Pips):
MaxDownTurn:===Maksimal Draw Down (Pips):
MaxProfit:===Maksimal Profit (Pips):
MaxProfitDate:===Maksimal Profit Dato:
MaxDownTurnDate:===Maksimal Draw Down Dato:
NumberOfLongTrades:===Antal Lange Positioner:
NumberOfShortTrades:===Antal Korte Positioner:
NumberOfProfitTrades:===Antal Vindende Positioner:
NumberOfLossTrades:===Antal Tabende Positioner:
PasteToRobot=Indsæt i Robot 
CopyParameters=Parametre til kopiering
NoRunningBackTest=Der er ikke fundet aktive Backtests.
NameWithColon=Navn:
LayoutOverride=Eksisterer allerede. Ønsker du at overskrive?
DefaultName= Gemt
EnterName:===Indtast Navn på Layout:
SaveLayout?===Gem Layout?
LoadLayoutNewWindow=Nyt Vindue
ClearHistoryConfirmationMsg=Er du sikker på at historik skal slettes?
StopRobotConfirmationMsg=Er du sikker på, at Robotten skal stoppes?
NetExposure%=== Nettoeksponering i %:
ManualOrdersKey=Ordre
PartnersKey=Partnere
MainMenuKey=Handel
MyAccountKey=Min Konto
MySettingKey=Mine Indstillinger
ChangeSettingKey=Profil
CurrencyExposureKey=Valutaeksponering
SymbolExposureKey=Symboleksponering
AdminKey=Admin
WindowsKey=Faneblade
CRMKey=CRM
ViewKey=Se
PartnerKey=Broker
SharedTechnologyKey=Delte Elementer
LoginKey=Log Ind
LogoutKey=Log Ud
ProfileKey=Profil
UISettingsKey=Brugerindstillinger
SharedInfoKey=Delt Information
EventLogKey=Event Log
MarketPriceKey=Kurslisten
ChartKey=Graf
RobotTradingKey=Robothandel
MyStrategyKey=Mine Strategier
SharedStrategyKey=Delte Strategier
CustomIndicatorKey=Opret Indikatorer
CustomerDetailsKey=Kunder
GroupDetailsKey=Grupper
ManageUserKey=Brugere
PartnerManageUserKey=Partnere
UserTrackInfoKey=Bruger Tracking Info
RunningRobotKey=Robots Status
LimitOrders=Limit Ordre
ManagementKey=System Oversigt
RunningBacktestkey=Backtests Status
SavelayoutKey=Gem Layout
LoadlayoutKey=Hent Layout
ClearSavedKey=Slet Gemte
CloseAllKey=Luk Alle Faneblade  
OpenAllKey=Åben Alle Faneblade
TradingStrategyKey=Handelsstrategi
AccountKey=Konti
TradingSymbolsKey=Handelssymboler
CleanUpKey=Opryd
WelcomeKey=Velkommen
CleanupInvalidDateMessage=Vælg venligst valid dato
ClenupLogsSuceessMessage=Du har succesfuldt ryddet op i logs. 
CleanUpLogKey=Opryd Event Log
CleanUpTrackingKey=Opryd Spor
CleanUpRobotKey=Opryd Robot Log
CleanUpAccountLogKey=Opryd Konto Log
CleaningLogMessage=Er du sikker på, at du ønsker at slette alle Logs ældre end {0}?
CleaningTrackMessage=Er du sikker på, at du ønsker at slette alle Spor ældre end {0}?
CleaningRobotMessage=Er du sikker på, at du ønsker at slette alle Robot logs ældre end {0}?
CleaningAccountLogMessage=Er du sikker på, at du ønsker at slette alle Konto logs ældre end {0}?
SharedStrategiesKey=Delte Strategier
BusyIndicatorLoggingIn=Logger ind
BusyIndicatorRegisteringUser=Vent venligst.....
BusyIndicatorSavingSettings=Gemmer dine oplysninger....
LoginIdExists=Brugernavnet findes allerede. Indtast et nyt
AccountExpireMessage===, din konto er udløbet.
AccountCloseMessage===, din konto er blevet lukket.
LoginErrorkey=Login fejlede. Prøv venligst igen.
LoginId=Indtast Brugernavn:
LoginPassword=Indtast Adgangskode:
ConfirmPassword=Gentag Adgangskode:
LoginName=Navn:
LoginEmail=Email:
SecurtyQuestion=Sikkerhedsspørgsmål:
GuestRegistration=Opret Demokonto
GuestUserReg=Bruger Registreringsform
GuestUserInfo=Bruger Information
GuestLoginInfo=Login Information
Answer=Svar:
UserSettingsheader=Udfyld venligst alle obligatoriske felter for at ændre din konto.
Task=Mine Opgaver:
Tasks=Opgaver:
Status=Status:
Role=Rolle:
Email=Email
PriceCategory=Priskategori:
CustomerType=Kundetype:
NewuserHeading=Opret Ny Bruger
GeneralSetings=Generel Opsætning
SLLBeginning=Gem og hent layout ved lukning og opstart
DisplayTime=Vis tid som:
Themes=Temaer:
DGPageSize=Antal linjer i graf:
ChartSettings=Grafopsætning 
HeikinAshi=Heikin-Ashi
Standard=Standard
DefaultCandleStick=Standard Candlestick
Language=Sprog:
CandleStickType=Candlestick type:
AggCandleStick=Aggregerede candlesticks?
AggregationLimit=Aggregering Begrænsning:
TrdChrtSettings=Handelsgraf Opsætning
NotcPoints=Antal trading point i graf:
LocalTime=Lokaltid
UtcTime=UTC Tid
DarkTheme=Mørkt tema
LightTheme=Lyst tema
CandleStickSetting=Candlestick
OHLC=Ohlc
Yes=Ja
No=Nej
ClosePosition=Luk Positioner
LeavePosition=Forlad Position Åben
SymbolCollectionKey=Symboler
WizardWelcome=Velkommen til Expression Wizard
WizardWelcomeDesc=Du har oprettet en graf i den venstre side af skærmen. Grafen består af priser og indikatorer. #Ved brug af Udtrykkene kan du vælge en af de mulige værdier og sammenligne dem mod hinanden. Når du sammenligner værdier, vil værdierne enten blive SANDE eller FALSKE. #Når Udtryk "Åben Lang" blive SAND, LiveChartTrader køber en lang position. Når Udtryk "Luk Lang" bliver SAND, LiveChartTrader sælger den position, og tilsvarende for /Åben/Luk Kort Position.
WizardIndicator=Du kan nu vælge en værdi fra en af indikatorerne.#I "Periode" indtastes "Antal perioder" som indikator værdien repræsenterer. 0 er den seneste værdi. 1 er den forrige værdi. 8 er indikatorværdien for 8 perioder siden.
WizardPrice=Du kan nu vælge en pris fra et af symbolerne.#I "Periode" indtastes "Antal perioder" som prisen repræsenterer. 0 er den seneste pris. 1 er den forrige pris. 8 er prisen for 8 perioder siden.
WizardFixed=Du kan nu sammenligne en pris eller en indikator værdi overfor en fast værdi. Indtast den faste værdi her.
WizardDate=Ved brug af datoer kan du aktivere din strategi på specifikke tidspunkter på dagen. Du bør kun anvende datoer ved "Åbne" udtryk.
WizardParameter=Du kan sammenligne en pris eller en indikator værdi overfor en brugerdefineret værdi. Dette er mere fleksibelt end brug af fast værdi.#Bemærk venligst at parametre først skal oprettes i fanebladet "Parameter".
WizardSystem=Under Systemfunktioner, kan du tilgå statusinformationer af din handelsrobot.
WizardType=Et udtryk har altid en venstre side og en højre side, samt en sammenligningsfunktion i midten. Den venstre og den højre side kan være med alle typer.#Vælg hvilken type denne side skal være:
WizardComparison=Vælg en sammenligningsfunktion mellem den venstre og den højre side af udtrykket.
WizardFinish=Denne tekst vil nu blive indsat i feltet for udtryk. Du kan redigere teksten og indsætte tal og +-*/&(og)|(eller).#Du kan finde markøren i tekstfeltet og bruge denne wizard igen, hvis du ønsker at indtaste et ekstra udtryk.#Du kan også slette tekstfeltet og starte forfra.
Date=Dato
FixedValue=Fast Værdi
Parameter=Parameter
Math=Matematik
lblMath=Matematik:
WizardMath=Vi har et bibliotek med matematiske funktioner.#Nogle funktioner såsom Abs, Cos, Sqrt anvender et parameter; Abs(MA.MA)#Nogle funktioner såsom Min, Max, Pow anvender 2 parametre; Max(Price.Close, Price.HaClose)
lblFunctions=Anvend Funktion:
Error=Fejl
OperationUnsuccessfulMsg=Operationen kan ikke fuldføres.
CouldNotDelete=Kan ikke slettes.
CouldNotLoad=Data kan ikke loades.
AccountDoesNotExsist=Konto eksisterer ikke
UserDoesNotExsist=Bruger eksisterer ikke.
CouldNotSave=Data kunne ikke gemmes.
Exception=Der er et problem ved at udføre denne operation.
NoRights=Du er ikke autoriseret til denne operation. 
NoSucces=Operation mislykkedes.  
UserNotLoggedIn=Du er ikke logget ind. Venligst log ind for at fortsætte. 
RobotIsAllreadyRunning=Robot kører allerede.
TrackTooSmall=Sporet er for lille.
TrackUsedByAnotherRobot=Sporet er allerede anvendt af en anden robot.
VolumeTooSmall=Volumen er for lille.
CouldNotStartRobot=Kunne ikke starte robot.
RobotIsStillUpdating=Robot afventer fortsat ordrebekræftelse. Venligst vent mens historikken fjernes.
UserAlreadyExists=Dette Bruger ID eksisterer allerede. Indtast et nyt Bruger ID.
UserCreationFailed=Oprettelsen af brugeren mislykkedes. Venligst prøv igen.
ErrorMsgOnLineNumber=Fejl på antal linjer:
VolumeNotInMultipleOfMinVolumeMsg=Volumen skal være multipel med Minimumhandelsvolumen.
UAccount=Konto:
UCurrency=Valuta:
UCreate=Opret ny konto
OpenInitialOrderMsg=Robot er startet succesfuldt. Hvad ønsker du at robotten skal gøre:
FirstPosition=Første Position
RobotPosition=Robot Position
AddPartner=Tildel Bruger til Partner
DeletePartner=Fjern Tildelte Partnere
Partner=Partner
ViewAddedPartners=Vis Tildelte Partnere
PartnerDeleteMsg=Partnere slettet succesfuldt.
PartnerAddedMsg=Partnere tilføjet succesfuldt.
UsersWithoutPartners=Brugere uden Partnere
OpenPositionNow=Åben en position nu
WaitForNextCycle=Vent indtil næste handelscyklus
DeleteUser=Slet Bruger
ModifyUser=Rediger Bruger
DeleteUserMessage=Den valgte bruger er nu slettet.
ChangePasswordMessage=Adgangskode er nu ændret.
BackendClientIdMessage=Backend Kunde Id er nu tildelt.
CreateUserMessage=Brugeren er nu blevet oprettet.
UserInfoKey=Brugerinformation
LoginInfoKey=Login Information
IsDeleteUserMessage=Er du sikker på, at du ønsker at slette den valgte bruger?
CustomerManagement=Klienter
PartnerManagement=Klienter
HisLivechartTrader=Hans Straticator
InstallOnComputer=Installer Straticator på din PC
RemoveOnComputer=Straticator er allerede installeret.
TSSymbols=Symbol:
TSActive=Aktiv:
TSDecimals=Decimaler:
TSCategories=Kategorier:
TSQuotesize=Kurs Størrelse:
TSSpread=Spread:
TSSymbolType=Symbol Type:
TSImport=Importer Symboler
TSID=ID:
TSName=Navn
TSTradingType=Handel:
VTSID=Id-felt skal udfyldes.
VTSName=Navnefelt skal udfyldes.
VTSSymbol=Symbolfelt skal udfyldes.
VTSDecimals=Decimalfelt skal udfyldes.
VTSQuotesize=Kursstørrelse skal udfyldes.
VTSCategories=Kategorier skal udfyldes.
VTSDuplicate=Duplikeret Symbol
VTSValidSymbol=Indtast venligst gyldigt valutapar.
VTSSpread=Spread skal udfyldes.  
Notifications=Notifikationer
ConfirmMessage=Er du sikker?
InvalidParameter=Ugyldig Parameter Værdi
NotificationToolTip=Ny Notifikation. Klik for at læse den.
FavouriteKey=Mine Favoritter
AboutKey=Om
BadUNamePwrdMessage=Brugernavn eller adgangskode er forkert.
LoginFailedMessagekey=Log Ind fejlede. Prøv igen.
MandatoryMessage=Vælg selv dit brugernavn og adgangskode. Alle felter skal udfyldes.  
MandatoryField=Dette felt skal udfyldes.       
TradingPermission=Du har ikke tilladelse til at handle. 
VCommon=Indtast en valid værdi.
DemoMode=Demo Mode:
TrailingStop=Trailing Stop:
VFavourite=Der er ingen favoritsymboler. For at oprette et favorit symbol, skal du klikke på "Symboler" under "Min konto" menuen, så skal du dobbelt-klikke på boksen (under "Favorit" kolonnen) ud for symbolet du vil have som favorit, og klik så på OK knappen for at gemme ændringerne.
AddGroup=Opret Gruppe
DeleteGroup=Fjern Gruppe
PriceType=Pris Type:
From=Fra
To=Til
CurrentValue=Nuværende værdi
Step=Step
System=System
BackTestStepIncreasedInfo=Info: Grundet mere end 100.000 kombinationer i backtest, ‘Step’ er øget for at reducere antal kombinationer.
SavingInputs=Gemmer Input
StrategySaved=Strategi er blevet gemt.
Message=Besked
SL/TP=SL/TP
TrackInfoClearMsg=Du har succesfuldt slettet alle tidligere SporInfos
LogClearMsg=Du har succesfuldt slettet alle gamle logs før
UnhandledException=Serveren er stødt på et problem! Venligst prøv igen senere.
BackendClientIdRequired=Venligst indtast Kunde Id for at fortsætte.
UserRequiredKey=Venligst vælg en bruger for at fortsætte denne operation. 
UserPasswordChage=Din adgangskode er ændret. Venligst log ind igen
BulletType=Punkt Type
FillGraph=Fyld Graf
LoginWindowTitle=Straticator Login System
DefaultSymbol=Standard Symbol:
SaveExit=Gem & Afslut
TradingChartPointMsg=Trading points skal være mellem 30 og 300.
PageSizeNumeic=Sidestørrelsen skal være numerisk.
PageSizeLimit=Sidestørrelsen må ikke være mindre end 20.
LoginIdWhiteSpace=Venligst ikke anvend mellemrum i Login ID.
GuestUserRegFailed=Demo-brugeren kunne ikke oprettes. Venligst prøv igen.
SlUpdate=Ny version af Straticator er hentet. Luk venligst Straticator og start igen.
SlApplicationUpdate=En opdatering til applikationen er tilgængelig, men kræver en ny version af Silverlight. Besøg Microsoft's hjemmeside for at opgradere.
ChangePasswordkey=Skift kodeord
GenerateBackendClientIdkey=Tildel Klient ID
EmulatedTransactions=Transaktioner
StopLossBankMessage=Banken har stoppet ud (lukket) alle åbne positioner. Denne operation vil slette alle robotter og handler eftersom banken har lukket alle positioner
RobotTerminateMessage=Denne operation vil slette alle robotter og lukke alle åbne positioner
Start=Start
OptimizationStrategy:===Optimer Strategier:
Optimization=Optimer
PeriodFrom=Period Fra
PeriodTo=Period Til
AssignBCIDKey=Tildel Backend Klient ID.
BackendClientId=Backend Klient ID:
MarketClosed=Markedet er Lukket
CleanUpNotification=Notifikation om Oprydning
CleaningNotificationMessage=Er du sikker på, at du ønsker at slette alle notifikationer ældre end {0}? 
NotificationClearMsg=Du har nu slettet alle tidligere notifikationer 
AccountLogClearMsg=DU har nu slettet alle tidligere konto logs
ReferenceDate=Reference Dato
LeftReference=Venstre side af Graf
FirstReference=Første dato i Graf
LastReference=Sidste dato i Graf
BetweenReference=Dato mellem første og sidste dato
BackTestError=Der er en fejl i backtest. Backtest blev afbrudt.
BackTestAborted=Backtest er blevet afbrudt.
UserIdSplChrMsg=Login ID må ikke indeholde specielle tegn. 
AvoidWhiteSpaceMsg=Venligst ikke anvend mellemrum i Login ID
LoginIdlength=Login ID skal indeholde mindst 3 karakterer
ViewStrategicReport=Strategirapport
SRPrintPreview=Print
SRParameterName=Parameter Navn
SRPrompt=Prompt
SRInputMask=InputMask
SRValue=Værdi
SRParameters=Parametre:
SRValidateXML=Fejl ved læsning af XML fil!
SRXMLVersion=Denne xml version er ikke understøttet.
KeepRunning=Fortsæt kørsel og Afslut
KeepRunningMessage=Backtest vil fortsætte med at køre. Venligst find resultatet under menuen Værktøjskasse/Backtest Resultat.
GraphWindow=Grafvindue
Decimals=Decimaler
Id=ID
STTradeId=HandelsId
ModifiedOn=Modificeret på
Running=Kører
GHLoginId=LoginID
CodeID=KodeId
Use=Brug
Favourite=Favorit
NotificationType=Notifikations Type
NotifiedOn=Notificeret 
CreatedBy=Oprettet af 
Demo=Demo:
Uid=Bruger ID
NumberOfTrades=Antal Handler
Iterations=Iterationer
OpenVolume=Åben Volumen
OpenPrice=Profit(USD)
Ask=Udbud
Bid=Bud
Ticks=Ticks
Second=Sekunder
Minute=Minuter
Hour=Timer
Day=Dage
TimeFrames=Sekunder#Minuter#Timer#Dage
TimeFramesOne=1 Ticks#1 Minut#1 Time#1 Dag
InputNumOf=Antal:
TimeframeTitle=Indsæt candlestick tidsramme
VTime=Venligst indsæt tid.
TradingGraph=Handelsgraf 
Smoothing=Anvend funktion
Method=Metode
NumberOfPeriod=Antal Perioder
UseIncompleteCandlestick=Anvend ukomplet candlestick
RememberMeKey=Forbliv logget ind
Import=Importer
WelcomeMessage=Velkommen {0}
PasswordRecoveryWindowsTitle=Gendan Adgangskode
WelcomeMessageQueryString=Admin adgang på : {0}
Help=Hjælp
PersonalIndicator=Personlig Indikator
RobotSaved=Robot er blevet gemt.
ChangeUserInfo=Rediger profil
VCreateRobot=Vælg venligst strategi.
ReloadRobot=Load Strategi igen
ReloadRobotMsg=Robotten tager en kopi af strategien, når den er oprettet. Hvis strategien modificeres, vil robotten ikke blive påvirket. Du kan uploade den modificerede strategi til robotten. Er du sikker på at du ønsker dette?
TerminationStrategy=Slet Strategi
Manual=Manuel
Time=Tid
OpenClose=Efter Åben og Luk
Open=Efter Åben
StrategyNotFound=Strategi eksisterer ikke.
TerminationReason=Årsag til sletning:
Mode=Tilstand:
Trade=Handel:
Live=Live
LongPlusShort=Lang + Kort
LongOnly=Kun Lang
ShortOnly=Kun Kort
BackTestRange=Backtest Område
OptionalRatio=Valgfri Ratio
StartTimframe=Start Tidsramme
EndTimeframe=Afslut Tidsramme
NumberOfSteps=Antal steps
FixedSpread=Fast Spread
Spread=Spread
Optimize_All=Optimer Alle
Optimize_Parameters=Optimir Parametre
Optimize_SLTP=Optimer SLTP
No_Optimization=Ingen Optimering
NewStrategy=Ny Strategi
NumberOfRobots=Antal robotter
BackTestResultKey=Backtest Resultat
EditUser=Rediger Bruger
Actions=Handlinger
RunningBackTestsKey=Kører Backtests
AdManagementKey=Ledelse
EnumPriceType=Mix#Udbud#Bud
MarketType=Market#Quoted#Limit#Buy/Sell Stop#Take Profit#Stop Loss#Trailing Stop Loss#Broker Adjustment
EnumUserOrderOrigin=Manual#Robot#Trade#Stopout#Copy Trade#MT4#API#Copy Master Manual#Broker Adjustment#Mobile#FIX-Intern#FIX-Extern#Upper Balance#Lower Balance#Position#Close
EnumUserOrderArchieveStep=Traded#Modified#Cancelled#Cancel Related#Cancel Stop Out#Cancel Neutral Position#Expired#Rejected#Cancel Exceed Margin#Cancel Increase Position#Cancel OTO#Cancel Account Disabled#Pending#Partially Traded
DurationType=Good til Cancel#End of Day#End of Week#Immediate or Cancel#Fill or Kill#Time Frame
DurationShort=GTC#Day#Week#IOC#FOK#Time
Order=Ordre
History=Historik
EnumCustomerType=Amateur#SemiPro#Professionel#Institutionel
EnumUserTasks=Manuel Handel#Se Strategier#Rediger Strategier#Se Indikatorer#Rediger Indikatorer#Se Robotter#Rediger Robotter#Operer Robotter#Se Transaktioner#Tilføj Konto#Ændre Gearingsgruppe#Rediger Delt Info#Rediger Profile#Copy Trader Master, Manuel Handel hos følgere#Copy Trader Master#Kill Backtest#Se Admin#Rediger Admin#Se Broker Opsætning#Rediger Broker Opsætning#Se Brugerdata#Rediger Brugerdata#Se Bruger#Rediger Bruger#Handle på Bruger Konti#Indtast Indskud#Copy Trader Master Offentlig#Choice Liquidity##Admin#Broker#Master Broker#Update Interest
EnumUserStatus=Åben#Blokeret#Slettet
EnumUserRoles=Demo#Trader#Professional#Institutional#Broker#Admin#SystemAdmin
ExtendGuestAccount=Forlæng Demokonto
ExtendGuestAccountMessage==={0} 's demokonti blev forlænget.Venligst informer brugeren om forlængelsen, så brugeren kan fortsætte med at arbejde.
GuestAccountExtensionNotNeeded==={0} 's demokonti er allerede aktiv. Der er ikke behov for forlængelse nu.
UpdateTimeFrameKey=Opdater Tidsramme
OperationSuccessfulMsg=Operation gennemført succesfuldt.
AveragePrompt=Gennemsnitlig Metode
SmoothingPrompt=Udjævningsmetode
PeriodPrompt=Antal Perioder 
CandlestickPrompt=Candlesticks Anvendt
PricePrompt=Priser anvendt
AverageTooltip=Vælg metode til at generer et jævnt gennemsnit
SmoothingTooltip=Vælg udjævningsmetode der skal anvendes til Gennemsnitlig Metode
PeriodTooltip=Antal søjler anvendt til beregningen
CandlestickTooltip=Vælg hvilke candlesticks der skal anvendes til beregningen
PriceTooltip=Det er høje og lave priser eller den anvendte pris brugt til at beregne indikatoren
MaxPricePrompt=Max Prisændring (pips)
MaxPriceTooltip=Den maksimale prisændring i løbet af et handelsvindue
StartAccPrompt=Start
StartAccTooltip=Den indledende accelerationsfaktor
StepAccPrompt=Step
StepAccTooltip=Accelerations step faktor
MaxAccPrompt=Maksimalt
MaxAccTooltip=Den maksimale accelerationsfactor
ShiftPrompt=Skift
ShiftTooltip=Antal søjler som prisen skal vises til højre
LipsPrompt=Antal Lips Perioder
TeethPrompt=Antal Teeth Perioder
JawsPrompt=Antal Jaws Perioder
ATRPrompt=ATR Perioder
MAPrompt=MA Perioder
CoefficientPrompt=Koefficient
CoefficientATRTooltip=Average True Range (ATR) vil blive multipliceret med denne faktor
ForecastPrompt=Prognose
ForecastTooltip=Antal søjler ('bars') som den lineære regression skal forudsige
CMPPrompt=Chande Momentum Perioder
CMPTooltip=Antal søjler ('bars') anvendt i Chande Momentum Oscillator (CMO)
OffsetComparePrompt=Offset to compare with
FastLimitPrompt=Fast Limit
FastLimtTooltip=If the phase rate of change is negative or small, the value of alpha is set to the Fast Limit
SlowLimitPrompt=Slow Limit
SlowLimitTooltip=If the phase rate of change is large, the value of alpha is set to the Slow Limit
SmoothReducePrompt=Smooth Reduce factor,G
SmoothReduceTooltip=Number of times that the smoothing constant is multiplied with itself to reduce its effect
 FastPeriodPrompt=Hurtig Periode
 SlowPeriodPrompt=Slow Period
 SPNumberPrompt=Number of Short Periods
 LPNumberPrompt=Number of Long Periods
 SignalPeriodPrompt=Number of Periods in Signal
 %KPPrompt===%K Periods
 %DPPrompt===%D Periods
 AvgPPrompt=Average Periods
 BPPrompt=Basispris
 MULPrompt=Margin Øvre Niveay
 MLLPrompt=Margin Lavere Niveau
 PipsDeviationPrompt=Deviation in pips
 PipsDeviationTooltip=How many pips is needed to signal a difference in price
 TSPrompt=Trend Strength
 PatternPrompt=Pattern
 SSPPrompt=Stochastics Smooth Periods
 SwingBarsPrompt=Bars on swing point
 SwingBarsTooltip=Number of bars required on each side of the swing point
 SignalPrompt=Signal 
 BandDeviationTooltip=The Standard Deviation (stddev) will be multiplied with this factor
 BandDeviationPrompt=Band Deviation
 LookBackLength=Look back bars
 LookBackLengthTooltip=How many bars back should be looked at, to determine new direction
 SecInTimeFrame=Seconds in Timeframe
Flag=Flag
TFId=TFId
PriceVolume=Pris*Volumen
SSymbol=Vælg Symbol:
SRobot=Vælg Robot:
EnumBackTestMethod=Best Iteration Profit#Best End Profit#Smallest Draw Down With Best Iteration Profit#Smallest Draw Down With Best End Profit#Best Iteration Profit Draw Down Ratio#Best End Profit Draw Down Ratio#Best Iteration Profit Draw Down Optional Ratio#Best End Profit Draw Down Optional Ratio#Most Profitable Trades#Most Profitable Trades Ratio
FilterTitle=Søg
RefreshTitle=Ryd Søgning
Expired=Udløbet den
AddBroker=Tilføj Broker
NewTradingSymbol=Nyt Handelssymbol
SymbolID=SymbolId:
RecordAlreadyExists=Data ('record') eksisterer allerede. Venligst prøv igen med ny data.
Brokers=Brokers
BrokerName=Mæglernavn
BrokerId=Broker ID
BrokerFlag=Flag 
BrokerCreatedMsg=Broker oprettet.
BrokerUpdatedMsg=Broker opdateret.
PriceMarkUpGroups=Pris Markup Grupper
PMGId=PMGId
AddPMG=Tilføj Pris Markup Gruppe
PMGCreatedMsg=Pris Markup Gruppen blev oprettet.
PMGUpdatedMsg=Pris Markup Gruppen blev opdateret.
GoToError=Gå til fejl
PMGName=Pris Markup Gruppenavn
MarkUpKey=Pris Markup
SaveAllKey=Gem alle
Symbolkey=Symbol
Markup1Key=Markup 1
Markup2Key=Markup 2
Markup3Key=Markup 3
Markup4Key=Markup 4
MarkupLevel1Key=Markup Niveau 1
MarkupLevel2Key=Markup Niveau 2
Markuplevel3Key=Markup Niveau 3
fee1Key=Fee 1
fee2Key=Fee 2
fee3Key=Fee 3
fee4Key=Fee 4
FeeLevel1Key=Fee Niveau 1
FeeLevel2Key=Fee Niveau 2
FeeLevel3Key=Fee Niveau 3
ShortInterestKey=Short Interest
LongInterestKey=Long Interest
PricemarkupCreatedMsg=Pris markup detaljer er Gemt.
PricemarkupSaveFaileddMsg=Pris markup detaljer er ikke gemt. Venligst prøv igen.
OrderID=Ordre ID
SellOrder=Salgsordre
HStopLoss=Stop Loss
HTakeProfit=Take Profit
TPOrderId=TPOrderId
SLOrderId=SLOrderId
HOpen=Åben
InMarket=In Market
ClosePrice=Lukkepris
DeltaPrice=DeltaPris
Pips=Pips
SumProfit=Sum Profit
PctOfProfit=PctAfProfit
OrderType=Ordretype
HOpenPrice=Købspris
SumPips=Sum Pips:
Action=Action
MarkupExplanation1=a.Pris markup er i pips.
MarkupExplanation2=b.Gebyr er i den anvendte valuta for dette. f.eks. CCY2
MarkupExplanation3=c.Renter er udtrukket fra de globale renter.
MarkupExplanation4=d.Volumen >= betyder at denne værdi vil blive brugt, hvis Volumen er større eller lig med denne værdi.
LeverageGroup=Gearingsgruppe
CreateLeverage=Opret Gearingsgruppe
LGId=Gearingsgruppe ID:
MarginCall1=Margin Kald 1:
MarginCall2=Margin Kald 2:
MarginCall3=Margin Kald 3:
StopCall=Stop out Kald:
MaxEntryMargin=Max Entry Margin 
AccountTransactionKey=Kontotransaktioner
LeverageName=Gearings Navn:
Orders=Ordre
VersionUpdateKey=Opdater Version
UpdateAidKey=Opdater Robot Konto-Id
Profit=Profit
TerminatedReason=Årsag til Sletning
OpenPosition=Åben Position
TotalTradingVolume= Total Handelsvolumen
Equity=Kontoværdi før Gevinst/Tab
AmountInvested=Beløb investeret
PL=Gevinst/Tab
PLSum=Gevinst/Tab Sum
MarginUsed===% Brugt Margin 
BrokerInfoKey=Mæglerinformation
BrokerHeaderKey=Mægler :
Aid=Konto ID
Oid=Ordre Id
ExternalId=Eksternt Id
SL=S/L
TP=T/P
RelatedOid=Related Order Id
OrderOrigin=Ordreoprindelse
currency=Valuta
clientAccount=Kundekonto
brokerAccount=Brokerkonto
tradeAccount=Handelskonto
BrokerAccounts=Mine Konti
AllFieldsMandatory=Alle felter skal udfyldes.
Deposit=Indskud
Withdrawal=Hævning
Correction=Tilpasning
BrokerAccountKey=Brokerkonto
SelectPMGKey=Venligst vælg en Pris Markup Gruppe for at fortsætte
PMGHeaderKey=PMG ID :
NationalityKey=Nationalitet:
NationalityHeader=Nationalitet
Amount=Beløb
MaxLeverage=MaxGearing
Leverage=Gearing
Statement=Kontoudtog
Trades=Handler
LoginId/Account=LoginID/Konto
Slippage=Slippage:
TransactionType=Transaktionstype
Total=Total
AccountType=Kontotype
AccountDetails=Kontodetaljer
AccountName=Kontonavn:
CurrencyWith3=Valuta (skal være 3 bogstaver):
AccountBalance=Kontodetaljer
CurrentPriceKey=Nuværende Pris
RealizedPL=Realiseret PL
ManageUserAccountBalanceKey=Bruger Kontobalance
ManageLiveUserAccountBalanceKey=Bruger Konto Balance.Live
ManageDemoUserAccountBalanceKey=Bruger Konto Balance.Demo
NumberInUSD=Alle tal er i USD
StEndDateValidationKey=Startdato skal være før Slutdato.
TradingDetails=Handelsdetaljer for {0}
GetLogs=Hent logs
UserDefinedLeverage=Brugerdefineret gearing:
UserDefinedStop=Brugerdefineret stop out:
DefineLeverage=Definer Gearing
UserLeverageDesc=Du kan definere din egen gearing til at være mindre end det din broker har tildelt dig. På denne måde kan du sikre dig, at du ikke gearer din konto for meget.
DepositOnDemo=Indskud på Demo
IsDefault=Er Standard
DefaultWarningMsg=Ønsker du at ændre din standard gearingsgruppe?
OrderHistoryKey=Ordrehistorik
TradesKey=Handler
AccountTransactionsKey=Kontotransaktioner
LinePostedSuccessfully=Linjen er blevet bogført
Success=Succes
UserDefinedLeverageMSG=Venligst indtast en gyldig værdi mellem 0 til 500.
RobotMenuKey=Robot
SettingsKey=Opsætning
OrderMenuKey=Aktive Ordre
AccountNo=Kontonummer
FromTrack=Fra Spor:
ToTrack=Til Spor:
DemoHeader=Demo
RiskBookKey=Risikobog
MaxLongExposure=Max Lang Eksponering
MaxShortExposure=Max Kort Eksponering
OrderQuantity=Ordre Antal
AmountUSD=Beløb USD
SelectAccount===--Vælg konto--
SelectAccountMsg=Vælg venligst konto
ExposureKey=Eksponering
ShowAll===--Vælg alt--
TradeTransactionKey=Handler og Transaktioner
RecordsAreUpdatedKey=Databasen er opdateret.
OriginOidKey=Oprindelse Ordre Id
OrderStepKey=Ordre Step
OrderStatus=Ordre placeret.
CreateSymbol=Opret Symbol
ErrorinLimitprice1=Fejl i Limit-pris. Pris skal være mindre end 'Købspris'.
ErrorinLimitprice2=Fejl i Limit-pris. Pris skal være større end 'Salgspris'.
ErrorinLimitprice3=Fejl i Limit-pris. Pris skal være større end 'Købspris'.
ErrorinLimitprice4=Fejl i Limit-pris. Pris skal være mindre end 'Salgspris'.
BrokerAccountsKey=Brokerkonti
TradeConfirmation=Handel Gennemført
OrderConfirmation=Ordre Gennemført
UseTrackskey=Anvend Spor:
WouldExceedMargin=Ordren vil overstige margin. Ordren afvist.
WouldExceedMarginSymbol=Ordren vil overstige margin for det valgte symbol. Ordren afvist.
CouldNotChangeValue=Værdi kan ikke ændres.
ValidateIsDefault=Du har allerede en default konto.{0}Ønsker du at gøre denne konto til din default konto?
AccountingKey=Indskud og Hævning
SetLimitKey=Sæt Limitering
SetupKey=Opsætning
StatementType=Kontoudtogstype
Balance=Saldo
BrokerMissmatchMessage= Du kan ikke logge ind! Fejl Misforhold med Brokers. Venligst kontakt administrator.
AccountNameKey=Kontonavn
BankNameKey=Bank Navn
BankBICKey=Bank BIC
BankLocationKey=Bank Lokation
BankKodeKey=Bank kode
IBANKey=IBAN
NationalBankAccountKey=Indenlandsk Bankkonto
LinkToOnlineTransferKey=Link Til Online Overførsler
ExchangeFeePctKey=Vekselkurs Pct
FIXViewKey=FIX
OpenPrices=Åbningspris
EnumTransactionType=Indskud#Hævning#Adjustment#Intern Overførsel#Gebyr#Renter#Realiseret PL#Udbytte#Ikke Realiseret PL#Balance#Roll Over#Primo Equity#Ultimo Balance#Samlet Ikke Realiseret PL#Ultimo Equity#Trade Exit#Trade Entry#Position
InvalidDataMessage=Ugyldig data indsat for felt {0}
AssignFIX=Tildel FIX
MinTradingVolume=Minimum Handelsvolumen
CurrencyId=Valuta ID
AddFIX=Tilføj FIX
BrokerErrorMesages=Venligst indtast navn på Broker.#Venligst indtast Adresse 1.#Venligst indtast Email.
SelectCountryKey=Vælg land
EmaiValidationKey=Indtast e-mail.
CountrySelectKey=Vælg land.
LoginIdRequired=Indtast Login ID.
LiveAccount=Live Konto
DemoAccount=Demo Konto
EmailFormatkey=Indtast venligst Email ID i korrekt format.
EnumDemoMode=Live Konto#Demo Konto#Test#Signal
FIXNameKey=FIX Navn
VersionKey=Version
IPAddressKey=IP Adresse
PortKey=Port
SenderSubIDKey=SenderSubID
SenderCompIDKey=SenderCompID
TargetCompIDKey=TargetCompID
TargetSubIDKey=TargetSubID
FlagsKey=Flags
DemoDepositMsg=Ønsker du at foretage et indskud til din konto?
TransferTextmsg=I tekstfeltet til overførslen skriver du:
DepositCurrencyMsg=Indskuddet skal foretages i følgende valuta:
DepositInstructions=Instruktioner til Indskud
ValidateFIXName=FIX navnefelt skal udfyldes.
ValidateVersion= Versions felt skal udfyldes.
ValidateVersionLength=Versions felt skal have gyldige værdier (4.1 etc).
ValidateIP= IP adressefelt skal udfyldes.
ValidatePort=Port felt skal udfyldes.
ValidatePortValue=Venligst indtast gyldig værdi for Port.
ValidateSenderSubId=SenderSubID skal udfyldes.
ValidateSenderCompId=SenderCompID skal udfyldes.
ValidateTargetCompID=TargetCompID skal udfyldes.
ValidateTargetSubId=TargetSubID skal udfyldes.
ValidateUserName=Brugernavn skal udfyldes.
ValidatePassword=Adgangskode skal udfyldes.
ValidateAccount= Konto skal udfyldes.
ValidateFlags=Flags skal udfyldes. 
EditFIX=Rediger FIX
UserNameKey=Brugernavn
PasswordKey=Adgangskode
BrokerAccountTradeKey=FIX Handler
TradeStatus=Status Handler
ViewTransactionsKey=Se Transaktioner
CurrencySymbol=Valutasymbol
NumberOfLimitOrders=Antal Limit Ordre
ActMarginNotification=Konto {0}:'{1}'. Margin er nu {2}%
ActPosClosedMarginNotification=Alle positioner lukket på Konto {0}:'{1}'. Margin er nu {2}%
WarnMargin=Konto {0}:'{1}'. Margin er nu {2}%, Stopout ved {3}%
WarnMarginSymbol=Konto {0}:'{1}'. Margin er nu {2}% for Symbol={4}, Stopout ved {3}%
WarnStopout=Alle positioner er lukket på Konto {0}:'{1}'. Margin er nu {2}%, Max tilladt {3}%
WarnStopoutSymbol=Positioner på Symbol={4} er lukket på Konto {0}:'{1}'. Margin er nu {2}%, Max tilladt {3}%
OrderExceptionNotification=Exception PlaceOrder. ID={0}-{1}, Ex={2}
ConfirmRegistrationUser=Din Konto er nu blevet oprettet. Venligst log ind med dit Login ID og adgangskode.
LeverageFactor=Gearingsfaktor:
LeverageFactorMsg=Gearingsfaktor skal udfyldes.
AddIdMsg=Venligst tilføj {0} ID.
OrderFailedStatus=Ordre er ikke placeret.
Permission=Tilladelse
Exceptionheader=Undtagelse
Invalid=Ugyldig
Duplicate=Duplikat
MinVolumeMsg=Volumen skal være større end {0} og multipel med {1}.
BackendClientkey=Backend Klient
ExternalAccount=Eksterne Konti
InvalidVolume=Ugyldig Volumenværdi.
RollOverKey=Roll Over
RunRolloverFor=Kør RollOver For
Run=Kør
RollOverConfirmation=Er du sikker på, at du ønsker at køre rollover!
RollOverRunSuccessfully=RollOver Kørt succesfuldt!
Exist=Eksisterer
Empty=Tom
UploadFileKey=Venligst vælg fil der skal loades
Failed=Fejlede
Robot=Robot:
ExpressionEditor=Udtryks Editor
More=Editor
Row=Line:
Column=Position:
Syntax=Syntax
EnumTradingSymbolType=Forex#Forex_Related#Index#CFD#StocksCFD#Futures#StocksReal
EnumTradingType=Lang + Kort#Lang#Kort#Ingen Handel
RecoverPassword=Gendan adgangskode
ForgotPassword=Glemt Adgangskode?
EmailSentMsg=Din adgangskode bliver sendt til din registrerede e-mailadresse.
InvalidLoginId=Login ID eksisterer ikke.
TradeVolumeKey=Handelsvolumen Rapport
NegativePrice=Salgsværdi
PositivePrice=Købsværdi
NegativeVolume=Salgsvolumen
PositiveVolume=Købsvolumen
HourlyVolumeTrade=Køb timevis/Salgsvolumen
Send=Send
BankReconciliation=Bank Afstemning
PostChanges=Publicer Ændringer
CorrectedValue=Korrekt Værdi
UpdatedValuesMsg=Værdier Opdateret.
UseRiskBook=Anvend Risikobog
Address1=Adresse1
Address2=Adresse2
Address3=Adresse3
EnumYesNo=Nej#Ja
VolumeOnBook=Volumen på Bogen
RiskMaxLongExposure=Max-Lang
RiskMaxShortExposure=Max-Kort
ReduceExposure=Reducer Eksponering
ZeroExposure=Nul Eksponering
BrokerAcctTradeOriginEnum=Automatisk#Manuel
ManageRiskbook=Håndter Risikobog
Difference=Difference
LoginReport=Login Rapport
LastTimeLogIn= Tid for Sidste Login
FIXid=FIX ID
Include=Inkluder
TradingType=Handelstype
FIXSymbols=FIX Symboler
RobotOrderRejected=Robot Ordre Afvist. RobotId={0}, Forklaring={1}.
ManualOrderRejected=Ordre Afvist. OrdreId={0}, Forklaring={1}.
ActiveKey=Godkendt
EnumEnableDisable=Deaktiver#Aktiver
AssignFixAccount=Tildel Fix Konto
FixAccounts=Fix Konti
FIXColon=FIX:
EditSymbols=Rediger Symboler
ViewSymbols=Se Symboler
Type=Type
LoginIdEmail=Login ID/Email:
CreateNew=Opret Ny
TradeSell=For OrdreId={0} solgte du {1} af {2} til {3}
TradeBuy=For OrdreId={0} købte du {1} af {2} til {3}
TradeSellAc=På Konto={0} solgte du {1} af {2} til {3} OrdreId={4}
TradeBuyAc=På Konto={0} købte du {1} af {2} til {3} OrdreId={4}
AllSymbolsKey=Alle symboler
ForexKey=Valuta
CFDKey=CFD
IndicesKey=Aktieindeks
MetalsKey=Metaller
MoneyManager=Copy Trader Master
Portfolio=Portefølje
PFid=PFID
Description=Beskrivelse
TradeConfirmationInfo=Handelsbekræftelse: Type={0} {1} Volumen={2} til Pris={3}, Tid={4}, OrdreID={5}, Konto={6}
OrderConfirmationInfo==={0} Ordre ID ={1}, Konto={2}
PhoneNo=Tlf nr:
selectCode=kode
selectCountryCode=Vælg telefonkode
ValidatePhoneNo=Indtast et gyldigt telefonnummer
EnumActivePortfolio=Aktive#AlleBrugere#GodkendFølgere
Pending=Afventer
AddPortfolio=Tilføj Portefølje
Create=Opret
Followers=Følgere
LeverageForex=Valuta Gearing:
LeverageMarginCall===(% of total gearing)
LeverageForexRelated=Valuta Relateret Gearing:
LeverageCFD=CFD Gearing:
LeverageIndex=Index Gearing:
LeverageStocks=Aktie Gearing:
LeverageFutures=Futures Gearing:
ForcePasswordChange=Gennemtving Ændring af Adgangskode
PMGIdRobot=PMGId Robot
LMGId=LMG ID
BackendClient=Backend Klient
LeverageNameErrorMsg=Gearings Navn Påkrævet.
AccountMoneyManagerAlreadyExists=Hver konto kan kun følge én Copy Trader Master. Skriv til Support@npinvestor.com, som derefter opretter ekstra konto.

AllUsers=Alle Brugere
ApproveFollowers=Godkend Følgere
Approved=Godkendt
InstantFollow=Følg med det samme
StartupScreen=Skærm Opstart
FollowMoneyManager=Følg Copy Trader Master
Website=Hjemmeside
CommonLeverageErrorMsg=Venligst indtast gyldig værdi.
MarkupGroupNameErrorMsg=Pris markup gruppenavn påkrævet.
ShowStartup=Vis widgets ved opstart
MarginUsedAmt=Margin brugt
DescWFavouriteSymbols=Bliv opdateret med markedsprisen på dine favoritsymboler
DescWRobotsStatus=Viser status på dine robotter
DescWNotifications=Vil holde dig opdateret med dine seneste notifikationer
DescWCurrencyExposure=Vil holde dig opdateret med din valutaeksponering
DescWSymbolExposure=Vil holde dig opdateret med din symboleksponering
DescWPrices=Vil vise dig de seneste priser
DescWMyAccounts=Hent din liste over konti
LeverageErrorMsg=Venligst vælg gearing.
MaxEntryMarginErrorMsg=Max Entry Margin bør ikke være større end 100.
AddFollowers=Tilføj Følger
LeveragePercentErrorMsg==={0} skal være større end {1}.
EditFieldAndvalue=Feltet "{0}" er redigeret og sat til en ny værdi="{1}". Kan du Accepterer dette?
SpreadMarkup=Spread Markup
PriceMarkup=Pris Markup
BrokerSymbolsKey=Broker Symboler
ExploreWidget=Undersøg og skræddersy side ved at vælge fra listen af tilgængelige widgets
MoreWidget=Mere>>
ManageWidgets=Tilpas Widgets
MasterBrokerId=Master Broker ID
WidgetExists=Du har allerede denne widget.
DescWMyChart=Tilpas din graf
PriceFix=Pris FIX
EnumTradePrice=Handel#Pris#BATS-Pris
FavoritesKey=Favoriter
Warning=Advarsel
RBNotEnabled=Risikobog er ikke tilgængelig
DefaultPrintingPrice=2-cifre fremhævet pris
SymbolNotTradeAble=Symbolet kan ikke handles
QuoteNoLongerValid=Kursen er ikke længere gældende 
PricesNotValid=Priserne er ikke opdateret, så kurserne er ikke rigtige.
ConnectionNotRunning=Forbindelsen til likviditetsudbyderen er nede. Ordren afvist. 
QuickTradeKey=Hurtig Handel 
ProfitLossReport=Profit-Tab Rapport
MasterBrokerPriceMarkup=Pris Markup fra Master Broker
TotalRiskBook=Kør fuld Risikobog
GlobalOverNightInterest=Overnight Interest from Global Setup
LongInterest=Lang Rente:
ShortInterest=Kort Rente:
MinPctMarkupClient=Minimun Pct Markup for IB
MinPctMarkupBroker=Mininum Pct Markup for Master Broker
Revenue=Indtægt
ActiveFollowed=Aktive jeg følger
WhatToFollow=Hvad kan jeg følge?
Follow=Følg
ShowPerformance=Vis Performance
MergeAccount=Sammenlæg Konti
Goingforward=Sammenlæg med:
DeleteAccount=Slet konto:
MergeAccountError=Sammenlægning af konto er ikke gyldig!
UnrealizedPL=Ikke Realiseret Gevinst/Tab
CustomerEmail=Kunde Email:
BrokerProfit=Indtægt
AmountCur=Sum konto valuta
WidgetAdded=Widget er blevet tilføjet.
FollowerAdded=Følger oprettet
FastPriceUpdate=Hurtig prisopdatering
MarkupGroupName=Markup Gruppenavn:
UserGroup=Bruger Gruppe:
SalesPerson=Sagsperson
AddSalesPerson=Tilføj Salgsperson
SPID=SPID
SalesPersonName=Salgsperson Navn:
Select===<--Vælg -->
UserPricesAndMarkupKey=Brugerpriser og markup
UserAsk=Bruger Udbud
UserBid=Bruger Bud
Markup=Markup
DescWFollowedMM=Hold styr på den Money Mangers du følger
UserNotes=Bruger Noter
MasterBrokerAccount=Master Broker Konto
FollowUp=Følg op
HaveFollowedUp=Har fulgt op
Text=Tekst
IsdefalutWarningMsg=Ønsker du at ændre til default Pris Markup Gruppe?
UserLots=Anvend lots
Lots=Lots:
ValLotVolume=Venligst indtast lots.
LotSize=Lot Størrelse:
VTLotSize=Lot størrelse felt skal udfyldes.
TradeLotsConfirmationInfo=Handelsbekræftelse: Type={0} {1} Lots={2} til Pris={3}, Tid={4}, Ordre ID={5}
InvalidLots=Ugyldig lots værdi.
CurrencyAmount=Valuta(Sum)
AccountCurrency=Konto valuta
UserNoteEdit=Du har redigeret Noten for denne Bruger. Ønsker du at fortsætte?
PriceLots=Pris*Lots
NeverAsk=Spørg ikke igen
Later=Senere
InterestRates=Renter
ImportInterest=Importer Renter
InterestMarkup=Rente Markup
Widgets=Widgets
ReportsLive=Rapporter. Live konti
ReportsDemo=Rapporter. Demo konti
ShowPositions=Vis Positioner
HidePositions=Gem Positioner
USDRevenue=USD Indtægt
USDNegativePrice=Salgsværdi USD
USDPositivePrice=Købsværdi USD
InterestRevenueTransaction =Renter. Broker Konti
InterestUserAccounts=Renter. Bruger Konti
FeeRevenueTransaction=Fee Transaction Report
ActiveUsers=Aktive brugere
LastActive=Sidst Aktiv
LoginHistory=Login Historik
InternalTools=Interne Værktøjer
RecalculateBalance=Genberegn Saldo
ExitPrice=Afslut Pris
Entry=Entry
PointSize=Pip Størrelse
CreatedTime=Oprettet Tid
Amend=Ændre
Expiry=Udløb
AmendOrder=Ændre ordre
ErrorLimitOrder=Din ordre vil øge positionen. Take Profit og Stop Loss ordre kan ikke øge positionen.
LimitVolumeTooHigh=Din Take Profit og Stop Loss ordre kan ikke have højere volumen end din position.
InvalidOrder=Ugyldig ordre.
ErrorFollowMM=Kunne ikke følge Copy Trader Master, PFId={0}, På Konto={1}, Fejl={2}
ErrorFollowPos=Ingen handel foretaget af Copy Trader Master, PFId={0}, på Konto={1}, da kontoen allerede har positionen.
Maintance=Handlinger
MoveAmount=Overførsel Beløb
FromAccount=Fra Konto:
ToAccount=Til Konto:
TransferAccounts=Overfør mellem konti
InvalidSelection=Ugyldigt valg.
InvalidAmount=Ugyldig beløbsværdi.
AllReadyMerge=Konto allerede sammenlagt.
DeletedAccountId=Slet KontoID
MergedAccountId=Sammenlæg KontoID
Created=Oprettet
Merged=Sammenlagt
ErrorCode=Fejlkode
ErrorText=Fejltekst
MT4=MT4
MT4Sync=MT4 Sync
AccountDeleteConfirmationMsg=Konto {0}:{1} vil blive sammenlagt med konto {2}:{3}.{4}Derefter vil konto {5}:{6} blive slettet.{7}Er du sikker på du vil fortsætte?
AccountMarkDeleted=Sammenlægningen vil blive foretaget i weekenden.{0}Indtil da vil din konto være markeret som "slettet".
DeletedEditAccountMsg=Konto i sletningsmode. Redigering er ikke tilladt.
NoStrategyForRobotMsg=Der er ingen strategier defineret. Du skal have en strategi for at oprette en Robot.
LogType=Log Type
AccountLog=Konto Logs
EnumStatus= Ny#Send#Bekræftet
EnumLogType= Ukendt#Ny Ordre#Handelsordre#Ordre Ændret#Ordre Annuller#Konto Tilføjet#Konto Slettet
InvalidAccountCurencyMsg=Konti skal være i samme valuta.
InvalidAmountTransfer=Beløb er lavt eller konti skal være i samme Valuta.
InvalidAccountTransfer=Konto eksisterer ikke.
InvalidAmountExceedMargin=Beløb er mindre end saldoen eller overstiger margin niveau.
InvalidMergeAccountMsg=Konto skal være i samme Valuta eller Konto til sammenlægning har en åben position.
InvalidMergeAccountDelete=Konto er ved at blive slettet.
InvalidMergeAccountPos=Konto {0}, har positioner.
Layout=Layout
Trailing=Trailing
SelectLayout=Vælg Layout
SaveAsGlobal=Gem som Global
SaveAsDefault=Gem som Default
DeleteLayout=Slet Layout
MoreDataExists=Du har valgt for mange data. Vi er kommet tilbage med nogle data, {0} men du skal begrænse dine søgekriterier for at få det korrekte resultat.
AverageFifoMsg=Straticator kan vise positioner med en gennemsnitlig kostpris for alle handler per symbol eller Straticator kan vise en position for hver foretaget handel med dets egen kostpris.
CostModelPosition=Position vist som:
PositionPerSymbol=En position per symbol
PositionPerTrade=En position per handel
LifoMsg=Hver position kan lukkes ned individuelt og hver position kan have dets egen Stop Loss og Take Profit til positionen
UsePosIdMsg=Jeg ønsker at kunne lukke hver enkelt position individuelt
UseSLTPMsg=Jeg ønsker, at Take Profit og Stop Loss bliver vist til en position
ClosePosIndividually=Luk Position Individuelt
ShowSLTPOnPos=Vis Take Profit og Stop Loss til position
Average=Gennemsnit
Fifo=FIFO
SubBrokers=Sub-Brokers
AddAccountRight=Du har ikke rettigheder til at oprette en konto.
GuestToTrade=Demo Til Trade
PLMethod=PL Metode:
DeleteDemoAccount=Slet Konto
ClearUserMsg=Er du sikker på, at data skal fjernes på slettet bruger?
CleanUpUserKey=Opryd Brugere
AllowManualTrading=Tillad Direkte Handel på min konto
AllowAccountView=Tillad Masteren adgang til min konto
ShowContactInfo=Vis mine kontaktdata til Masteren
TradesMoneyManager=Handler hos Copy Trader Master
TradesFollowers=Handler hos Følgere
OrderHistoryFollowers=Ordrehistorik hos Følgere
FromSymbol=Fra Symbol:
ToSymbol=Til Symbol:
PortfolioFollowerReport=Portefølje Følgere Rapport
DeleteAccountException=Konto {0} er ikke slettet.
ContractSize=Kontraktstørrelse 
PhoneNoInfo=Telefonnummer
ContactInfo=Kontaktoplysninger
Confirm=Bekræft
ShowDemoOnLive=Vis Demo Konti, når de kører Live
TradingInWatchList=Åben Handelsvindue i Kurslisten
AllowManualTradingConfirmation=Du har valgt ‘Tillad Manuel Handel’ for Copy Trader Master.{0}Copy Trader Masteren kan nu foretage ordre og handle på din konto.{1}Er du sikker på, at du vil give Copy Trader Masteren tilladelse til at handle på din konto?
RightsAllowManualTrading=Du har ikke rettigheder til at handle på kundens konti.{0}Kontakt venligst Support-team og bed om rettigheder til at handle på kundens konti
NoAccountInfo=Du har ingen konto.
VildateWebAddress=Venligst indtast en gyldig adresse for hjemmesiden
MergeAll=Sammenlæg Alle
DeleteALLAccount=Slet alle med Succes
Interval=Interval:
Graph=Graf
VaildBrokerMarkupValue=Venligst indtast en værdi større end 0.1 eller 0.0
PriceMarkupPips=Pris Markup Pips
ReverseTrade=Tilbageføre Handel
TradeReversal=Handels Tilbageførsel
TradeCorrection=Justering af Handel
FIXIdTrade=FIX ID Handel
SignalLong=Robot={0} signaler går Langt på {1} til {2} Volumen= {3}
SignalShort=Robot={0} signaler går Kort på {1} til {2} Volumen= {3}
SignalNeutral=Robot={0} signaler går Neutral på {1} til {2} Volumen= {3}
TimeAgo=Tid Siden
EnumNotificationType=Info#Advarsel#Fejl#Undtagelse#MarginCall#StopOut#Handel#Afvist#DemoTrade#Signal
ClientOrigin=Client Origin
ClientOriginEnum=Ukendt#SilverLight#API#MT4#Mobile#FIXMarket#FIXTrade#Other
LogTime=Log tid
Counter=Tæller
ServerLog=Server Log
OnlyLastLogin=Kun Sidste Login
Logs=Logs
Queues=Køer
RightsMoneyManagerPublic=DU har ikke tilladelse til at dele din Copy Trader Master med andre brugere.{0}Venligst kontakt Support-teamet for at få tilladelse til at dele din{1} Copy Trader Master
SLnTPisExit=SL og TP anvendt som "Luk Lang/Kort"
OffLineAt=Offline At
OnLineAt=Online At
Connection=Forbindelse
ErrorAccount=Error Account
FridayClose=Fredag LukClose
Sunday Open=Søndag Åben
IncludeSubBroker=Inkluder Sub Broker
FIXidColon=FIX ID:
TradeCorrectionMsg=Denne justering vil generere en handel på Konto={0}, BrugerId={1}, til {2} med Volumen = {3} og en modhandel på brokerens Error Account={4}. Er du sikker på, at du ønsker at fortsætte?
ClientExposure=Kundeeksponering
FIXExposure=FIX Eksponering
BankExposure=Bankeksponering
ToolboxMenuKey=Værktøjskasse
CopyTrade=Copy Trade
MyCopyTraderMaster=Min Copy Trader Master
SharedCopyTraderMasters=Delte Copy Trader Masters 
TradeStatistics=Handelsstatistik
TradeStatisticsMoneyManager=Handelsstatistik på Copy Trader Master
TradeStatisticsFollower=Handelsstatistik på Følgere
RecalFixTradeSum=Beregn igen Fix trade sum
RecalFixTradeSumConfirmation=Er du sikker på, at du ønsker at beregne Fix trade sum igen? 
ErrorAccountUnavailable=Justering kan ikke foretages. Justeringskonto ikke tilgængelig.
FillToNext=No Fill#Fill to 0 Line#Fill to next Graph#Fill to prev Graph
DebugOutput=Debug Output
LastMessage=Sidste Besked
Reconnect=Reconnect
StrategyPrint=Show Strategy Print
StrategyPrintTitle=Strategy Print
ClearLog=Clear Log
BrokerAccountID=Broker Konto ID
PriceCodes=Pris Koder
ValidateCurrency=Vælg venlist en valid valuta !
OrderAcceptedConfirmation=Ordre modtaget. Ordre ID = {0}, på Konto = {1} Symbol = {2}. Straticator afventer bekræftelse og eksekvering fra likviditetsudbyder.
OrderRejected=Ordre Afvist. Ordre Id = {0}. Årsag = {1}
SlipPage=Slippage
ExecSpeed=Execution Speed
Depth=Dybde
BidPrice=Bud Pris
AskPrice=Udbuds Pris
BidOffset=Bud Offset(pips)
AskOffset=Udbud Offset(pips)
AskVolume=Udbud Volumen
BidVolume=Bud Volumen 
LoginFailedMsg= Vi kan ikke få forbindelse til serveren.{0} Det kan skyldes manglende internetforbindelse.{1} Venligst prøv at opdatere dit browser vindue.
OrderConfirmationDiff=Du lagde ordre på {0}, men du fik kun {1} af {2}.{3}Venligst tjek din konto før du handler igen.
FIXUsers=FIX Brugere
EnumFIXSessionType=Both#Trade#Market
AddFIXUser=Tilføj FIX Brugere
EditFIXUser=Rediger FIX Bruger
FIXGroupId=FIX Gruppe ID
FIXGroup=FIX Gruppe
FallBackFIXGroupID=FallBack FIX Gruppe ID
Enabled=Aktiveret
EditFIXGroup=Rediger FIX Gruppe
ADDFIXGroup=Tilføj FIX Gruppe
LiquidityPool=Likviditetspulje
Priority=Prioritet
SubSymbolId=SubSymbol ID
SymbolId=Symbol ID
SymbolType=Symbol Type
Effective=Effective
Settlement=Settlement
ExpireSalesPrice=Expire Sales Price
ExpirePurchasePrice=Expire Purchase Price
Collapse=Sammenlæg
InputSearch=Søgeparametre
AutoClose=Auto Luk
EnumSubSymbolType=Future#NDF
Futures=Futures
InvalidPrice=Venligst indtast en gyldig pris
Settled=Settled
FixMsg=Fix-Beskeder
InvalidTimeframeOrderType=Udløb = 'Tidsramme' kan ikke vælges for denne type ordre
TickSize=Tick Størrelse  
Connections=Forbindelser
ShowServerLogPopup=Pop up Advarsel med nye beskeder
ServerLogNewMsg=Ny besked er modtaget i Server Log
OTO=OTO
TriggerOrder=Trigger Ordre
MasterSymbolId=Master Symbol ID
InvalidSubsymbol=Venligst indtast et gyldigt SubSymbol
LastOrder=Sidste Ordre
Rejected=Afvist
BankOrderId=Bank Ordre Id
LimitOrdersInFix=Limit Ordrer i FIX
VolumeNotInMultipleOfMinVolume=Volumen skal være multipel med {0}
VolumeTooSmallWithParam=Minimum volumen er {0}
AddOvernightInterest=Tilføj overnight interest
Default=Default
Liquidity=Likviditet
CopyTraderMaster=Copy Trader Master
IndicatorId=Indikator ID
ExternalIndicator=Ekstern Indikator
AddExternalIndicator=Tilføj Ekstern Indikator
SenderId=Sender ID
AddIndicatorValues=Tilføj Indikator Værdier
ExternalIndicatorValues=Eksterne Indikator Værdier
ErrorInScript=Kunne ikke starte robot, da robotten har "compile errors in the script" til Strategien.
ChoiceLiquidity=Choice Liquidity
Trade%===Handel i %:
NumberofContracts=Antal Kontrakter
FIXSessionID=FIX Session ID
NoActiveLiveAccount=Du har ikke en aktiv live konto
UserRights=Brugerrettigheder:
FIXLog=FIX Log
LGIdWeekend=LGId Weekend
LGIdSymbol=LGId Symbol
FIXLogValues=Ingen#Valgt#Alle
UseOwnThread=Brug egen tråd 
ListenBeforeProcessing=Listen Before Processing
HasOwnLiquidity=Har Egen Likviditet
DepthSize=Dybde Størrelse
PriceFIXGroupId=Pris FIX Gruppe ID  
DynamicDepth=Dynamisk Dybde
RobotStopped=Robot '{0}' er blevet stoppet. Årsag={1}
ValidateBrokerID=Broker ID skal udfyldes.
ValidateChangePassword=Det er ikke tilladt at ændre adgangskode for denne bruger.
PopupNotifications=Popup Notifikationer
NotificationsMessage=Du har en ny besked i ‘Notifikationer’
EditFollower=Rediger Følger
SettingsMsg=Indstillinger Gemt. Ændringer vil blive vist efter næste login.
AccountsBalance=Kontobalance
PrDate=Vælg Dato
BrokerMarkupRevenue=Broker Markup Indtægt
TradeRevenue=Kunde Markup Indtægt
TotalExposure=Alle Positioner
NoConversion=Ingen Konvertering
BlueTheme=Blåt tema
DepositConfirmation=Indskud Bekræftelse
ChangedOn=Ændret den
ChangedBy=Ændret af
PasswordReport=Adgangskoderapport
ViewPassword=View Adgangskode:
ViewPasswordTitle=View Adgangskode
ViewPasswordCreated=Din 'View Adgangskode' er blevet oprettet.
LoginType=Demo#Live#View
ViewPasswordNotFound=Du har ikke oprettet 'View Adgangskode'.{0} Gå til Min Konto>>Indstillinger>>Profil for at oprette 'View Adgangskode'. 
RemoveKey=Fjern
CouldNotChangeCostModel=Omkostningsmodel kan ikke ændres, når kontoen har åbne positioner. Luk først alle positioner.
CostModel=Omkostningsmodel
UnrealizedPL_AC=Ikke Realiseret PL({0})
PerfStart=Performance Start
FastFollow=Hurtig Følg
TradingSessionClosed=Marked lukket. Ordren afvist.
OpenTime=Åben Tid
SelectSymbolMsg=Vælg venligst et symbol.
Waiting=Venter
Go=OK
Organize=Organiser
UserSymbols=Aktive Symboler
Inbox=Inbox
MailTo=Til:
Subject=Emne:
ComposeMail=Opret Mail
MailMessage=Dette felt (Til,Emne,Body) skal have værdier.
MailErrorMessage=Mailafsendelse mislykkedes - prøv igen senere.
SendMail=Send Mail
Reply=Svar
ErrorMsg=Ingen mail i inbox.
CopyTradingMethod=Copy Trading Metode
SupportDistributedPL=Support Distributed P/L
Contact=Kontakt
Older=Ældre
MailBroker=Mail Til Broker
selectFollower=Vælg venligst en Følger for at sende mail.
selectFollowers=Du har ingen følgere du kan sende mail til.
CopyTradingEnum=Copy Trading#Distributed P/L
CannotEditCopyTradingMsg=Du kan ikke redigere Copy Trading metode eftersom du har Følgere.
DefaultTrack=Default Spor
PauseRobot=Pause Robot
LinkAccount=Forbind Konto
UsedMargin=Margin Brugt
Level_0=Margin til handel
Level_1=Ingen margin til handel
Level_2=Advarsel niveau 1
Level_3=Advarsel niveau 2
Level_4=Advarsel niveau 3
Level_5=Stop Out
PauseAll=Pause All
StopAll=Stop All
PauseStopConfirmation=Er du sikker på, at du ønsker at {0} robotter handler på live konti?
TooBigATrade=Ordre ikke mulig. 
MaxSingleOrder=Max Værdi af Enkeltordre
Exchanges=Børser
CreateExchange=Opret Ny Børs
ExchangeId=Børs Id
CloseTime=Lukketid
Extension=Forlængelse
Suspended=Suspenderet
ExchangeNameErrorMsg=Børsnavn påkrævet.
ExchangeOpenTimeErrorMsg=Børsåbningstid påkrævet.
ExchangeCloseTimeErrorMsg=Børslukketid påkrævet.
ExchangeextensionErrorMsg=Børs forlængelse (extension) påkrævet.
Version42=Version 4.4
Encryption=Kryptering
InvalidLastPriceMsg=Kursfeed kører ikke. Venligst prøv igen senere.
Stocks=Aktier
TimeZone=Tidszone
ExchangeName=Børs
RunningProfit=Running Profit
RemoteIP=Remote IP
MaxLongPosition=Maksimum Lange Positioner:
MaxShortPosition=Maksimum Korte Positioner:
MinimumFollow=Minimum Følgere
InvalidMinimumFollow= Minimumsbeløb for at følge kan ikke være mindre end {0}.
InvalidAccoutNo=Kontonummer skal udfyldes.
MinFollowMsg===(Min:{0})
ShareToUSer=Del med Bruger
MakeReserve=Offset on Error Account
ShowTradeConfirmation=Vis Handelsbekræftelse
PositionId=Positions Id
UsePositionId=Brug Positions ID
CloseAll=Luk Alle Positioner
MaxFollow=Maksimum Følg
InvalidMaxFollow=Maksimumbeløb til at følge kan ikke være mindre end minimumsbeløb.
InvalidMinMaxFollow=Beløb til at følge kan ikke være mindre end {0} eller mere end {1}
OneFollowerPerUser=En Følger Per Bruger
RobotAccounts=Robot Konti
GuestUserConfirmation=Er du sikker på, at du vil slette alle Demo-brugere ikke logget ind efter {0} ?
GuestUserDeletedMsg=Demo brugere slettet.
CleanUpGuestUserKey=Opryd Demo-brugere
RealFactor=Real Factor
RealFactorCheckMsg=Real factor must be greater than 0
ClosePositionLable=Luk alle positioner når Balancen overstiger
Upperlevel=Øverste niveau 
Lowerlevel=Nederste niveau
Online=Online
Offline=Offline
ClientVersion=Klient Version
LimitCancel=Limit ordre på Symbol={0} Volumen={1} Konto={0} blev annulleret. Ville overstige margin"
ChooseSharedItem=Venligst vælg emne der skal deles. 
ShareType=Dele Type
ShareElementId=Del Element ID
SharedToMe=Delt med mig
Strategies=Strategier
SharedAccounts=Delte Konti
FollowerAddedMsg=Du følger nu Copy Trader Master {0} på din konto {1}.{2} Du kan stoppe med at følge Copy Trader Masteren ved at klikke Ændre,{3} og så fjerne afkrydsningen ud for “Aktiv” i dialogboksen og tryk <Save>.{4}Hvis du vil synkronisere din konto med Copy Trader Master, så tryk <Sync>,{5}eller du kan vente indtil Copy Trader Masteren handler, for da vil din konto automatisk synkronisere med Copy Trader Masteren. 
ShareAll===--Del Alle--
CTMRevenue=Copy Trader Master Indtægt
ClientRevenue=Kundeindtægt
StartAllPaused=Start All Paused
PositiveLots=Køb Lots
NegativeLots=Sælg Lots
PaymentRef=Betalingsreference
SecurityId=Sikkerheds Id
FixComment=Kommentar
OrderInProcess=Ordre bliver behandlet
SLTPOnPosition=Stop Loss og Take Profit til Positioner
SLTP=T/P:S/L
EditSLTP=Rediger T/P S/L 
RealizedPL_Cur=Realiseret Gevinst/Tab (Valuta)
MsgNoEditSLTP=Redigering af Stop Loss eller Take Profit er ikke aktiveret for denne konto. 
StopLossTooSmall=Stop Loss er for lille
OrganizeSymbols=Organiser Symboler
ForceSetTrack=Forcer Fastsat Spor
ActivateLog=Aktiver Log
On=On
Off=Off
Get=Hent
Sync=Sync
SyncConfirmationMsg=Er du sikker på, at du vil synkronisere din Konto med Copy Trader Master konto ?
AllTradesOpenPosition=Alle handler åbner en ny Position
PositionDetail=Detaljeret Positioner
PositionAggregate=Sammenlæg Positioner
TSPipsDecimals=Pips Decimal:
VTSPipsDecimals=Pips Decimal felt skal udfyldes.
ErrorIn=Fejl i
ClosedPositions=Lukkede Positioner
EditBrokerInterest=Rediger Renter
AddNewInterest=Tilføj Ny Rente
ValidateFIX=FIX Gruppe felt skal udfyldes.
MarkupType=Markup Type
Level=Niveau
MarkupLevel=Markup Niveau
EnumMarkupType=Pris Pips#Fee#Renter#Pris %
AddPriceMarkup=Tilføj Pris Markup
EditPriceMarkup=Rediger Pris Markup
LastUpdated=Sidst Opdateret:
FIXGroupName=FIX Gruppenavn
AllKey=Alle
SaveAllConfirmation=Import er gennemført.Ønsker du at gemme alle ændringer? 
ImportFailed=Import mislykkedes. Symbol "{0}" eksisterer ikke.
UpdateWarningMsg=FixGruppe for dette symbol eksisterer allerede.Ønsker du stadig at opdatere det?
DefaultMarkup=Default Markup Pips
DefaultMarkupPct=Default Markup Pct
TripleInterestDay=Triple Rente Dag
TripleInterestDayEnum=Ingen Triple#Mandag#Tirsdag#Onsdag#Torsdag#Fredag
SLTPAmountMsg=Beløb i {0}
MinFXVolume=Minimum FXVolumen
MinContract=Minimum Kontrakt
TradingDisabledOnAccount=Handel på kontoen er blevet deaktiveret. Kontakt administrator.
DisableTrading=Deaktiver Handelsmulighed
MinMarkupFee=Minimum Markup Gebyr
All===--Alle--
AccountStatement=Årsrapport
AddDividendKey=Tilføj Udbytte
DateandTime=Dato & Tid
Confirmation=Bekræftelse
ShowSymbols=Vis Symboler
PasswordConfirmation=Forkert adgangskode.
PasswordRequired=Adgangskode er påkrævet.
CreateUserAccount=Opret Konto
BandSize=Band Size
MaxLeverageLevel=Maks Gearingsniveau
GamePeriodNotOpen=Perioden for aktiespil er udløbet
GameLogin=Reg. til Aktiespil
Gaming=Aktiespil
Game=Aktiespil
PartialFilled==="Din ordre {0} på {1} er kun delvist blevet handlet. Bestilt={2} Fået={3}"
SplitSymbol=Split Symbol
DefaultTradeSize=Default Handelsvolumen
SetDefaultTradeSize=Gem Default Handelsvolumen
NewStraticatorVersion=En ny version af Straticator er tilgængelig. Tryk "Installer" for at opgradere din Straticator

UpgradeStraticator=Opgrader Straticator
Install=Installer
GoToLogin=Gå til Login
EmailTradeconfirmation=Send Email som Handelsbekræftelse
WatchlistUid=Kursliste Bruger Id
Watchlist=Kurslisten
ccMailUserId=ccMail Bruger Id
StocksReal=Aktier
StocksCFD=CFD Aktier
Positions=Positioner
Invested=Investeret
StocksCFDKey=Stocks CFD
StocksRealKey=Stocks Real
ExitStraticator=Vil du afslutte Straticator?
ExitStraticatorConfirmation = Bekræftelse
LIVETRADINGACCOUNT=Live Trading Account
PositionsKey=Positioner
SelectaccountKey=Vælg Konto
ReportsKey=Rapporter
StopFollowingMessage = Er du sikker på, du vil stoppe med at følge?
OrganizeKey=Organize
EditAccountMsg = Vælg venligst konto før redigering.
MinAmountKey = Minimumsbeløb
OrderstitleKey =Ordrer
TradestitleKey=Handler
savehidekey=Gem og skjul
NoneKey=Ingen
Cancel=Lukke
forgotloginpassword=Forgot Password
Register=Tilmeld
ClosePositionConfirmation=Er du sikker på, at du vil lukke positionen?
ErrorClosePosition=Du kan ikke lukke denne position af {0}. Luk venligst positionen ovenfor først
ValidationErrorRequiredField= felt er påkrævet
ValidationErrorBadPasswordLength= Adgangskoden skal bestå af mindst 7 tegn og færre end 30 tegn
ValidationErrorBadPasswordStrength = Adgangskoden skal indeholde mindst et special-tegn (!@%+)
ValidationErrorPasswordConfirmationMismatch = Adgangskoderne stemmer ikke overens
BecomeCustomer = Bliv Kunde
True=Ja
Flase = Nej