AdminPartners=Users
RequestLogin=Please login.
UserName=User name:
Password=Password:
PasswordChangeTitle=Change Password
GenerateGraph=Generate Graph
TimeFrame=Time Frame
EndDate=End Date:Amound(USD)
SelectLastDate=Select first or last date of chart
AddIndicator=Add Indicator
SelectIndicator=Select Indicator
ChooseSymbols=Choose Symbols:
ChooseIndicatorParameter=Choose Indicator Parameters
UpdateGraph=Update Graph
BackToChart=Back To Chart
Compare=Compare
ViewGraph=View Graph
SuperTrader=Super Trader
Copyright=©2010 Straticator. All Rights Reserved
ShowGraph=Show Graph
ShowValues=Show Values
BackToStrategie=Back To Strategy
CustomIndicator=Custom Indicator
Trading=Trading
MyAccount=My Account
SymbolCollections=My Symbols
RunningRobots=Robots Status
OK=OK
SetAsDefault=Set as Default
Reset=Reset
Apply=Apply
Name=Name
LastEdited=Last Edited
Owner=Owner
CreateIndicator=Create Indicator
EditCustomIndicator=Edit Custom Indicator
CreateCustomIndicator=Create Custom Code
Indicator=Indicator
GoToDate=Go To Date
Result=Result:
SShared=Shared:
UserID=ID:
CodeName=Name:
ParameterNumber=Number of Parameters:
Print=Print
IndicatorType=Indicator Type:
Simple=Simple
Complex=Complex
ReturnValueCount=Number of Graphs:
BuildTrader=Build or Edit Trader
TestTrader=Test Trader
RunTrader=Run or Inspect Running Trader
Indicators=Indicators
IndicatorName=Indicator Name:
AddParam=Add Parameters
ShowHistory=Show History  
AddIndicators=Add Indicators
AddRobot=Add Robot
ParamsAddedSuccessMsg=Parameters added successfully
Parameters=Parameters
View=View
Visible=Visible
ShowDelta=Show Delta
Color=Colour
UpdateView=Update View
Prev=<<Prev
Next=Next>>
WorkingPrice=Working Price:
GraphView=Graph View:
GraphType=Graph Type:
Finish=Finish
GraphAppearance=Graph Appearance

Delete=Delete
DeleteConfirmation=Are you sure you want to delete this?
CandleStickChartHeader=Candlestick Chart
IndicatorChartHeader=Indicators Chart
CandleStick=Candlestick
CollapseAll=Collapse All
ExpandAll=Expand All
DesignGraph=DESIGN GRAPH
CreateStrategie=Create Strategy
ViewBackTestResult=Backtest Result

TradingStrategie=Trading Strategy
BackToIndicators=Back To Indicators
AddExpressions=Add Expressions
TradeExpressions=Trade Expressions
RobotInputs=Inputs
RobotHasOpenPosition=Robot has an open position.
Compile=Compile
EnterLong=Open Long
EnterShort=Open Short
ExitLong=Close Long
ExitShort=Close Short
VolumeCheckMsg=Volume must be greater than 0
ChooseValidDateMsg=Please choose a valid date
ErrorInexpressionMsg=Error "{0}" in {1} expression#near token '{2}'#in line {3} at position: {4}
CompilationSuccessMsg=Compiled Successfully.#Compilation Result: # 
Value=Value:
Period=Periods:
NoOfPeriod=Number of Periods:
Delta=Delta:

SelectSymbol=Select Symbol:
SelectAnIndicator=Select an Indicator:
SelectGraph=Select Graph:
TextBoxEmptyMsg=Field cannot be empty
ComboBoxEmptyMsg=Please select a value
TradingStrategies=Trading Strategies
TradingExpression=Trading Expression
TradeId=Trade ID
CreatedOn=Created On
Clear=Clear
Comments=Explanation
TShared=Shared
SaveTrader=Save Trader
SaveAs=Save As...
New=New
TextBoxNonNegativeMsg=Value cannot be less than zero
Wizard=Wizard
Add=Add
AddSymbol=Add Symbol
DeleteSymbol=Delete Symbol
Comment=Comment:

SSelect=Select
SharedInfo=Shared Elements
SharedToOther=I Share with Other
SharedByOther=Shared By Other  
SUserName=Login ID:
SIndicators=Indicators:
STraders=Strategies:
STrading=Trading:
SAccount=Account:
SSearchUser= Search User
AddUser=Create User
SValidateUser=Please select a valid user.
SVSharedInfo=Login Id already shared by you.
STabFrom=Shared From
STabTo=Shared To  

SearchUserName=Search user name:

SearchValidate=Please fill out fields before searching.
SearchResult=No record found. Please verify your search.
MyTradingStrategies=My Trading Strategies
TradingStrategiesSharedByOther=Trading Strategies shared with me by others 
BackTest=Backtest

MPTitle=Market Price

MPStopLoss=Stop Loss (pips):
MPTProfit=Take Profit (pips):

MPIExecution=Instance Execution
MPQuoPrice=Enable maximum deviation from quoted price
MPMDeviation=Maximum Deviation
MPLTrader=Last Trader:
MPDuration=Duration:
MPSlipp=Slippage (pips):

FVTrade=Trade

ODPrint=Print
ODExport=Export to Excel

TAUid=User ID:
TAName=Name:
TAPassword=Password:
TARePassword=Retype Password:
TANew=New
TAEdit=Edit
TAId=ID
TAUName=User Name:

RORefresh=Refresh
Export=Export

CreateRobot=Create Robot
TerminateStrategie=Terminate Strategy:
Expiration=Expiration:
Started=Started
Stopped=Stopped
LastTrade=Last Trade
HasLongPosition=Has Long Position
HasShortPosition=Has Short Position
ResetWhenStarted=Reset When Started:

StopLoss=Max Lost:
TakeProfit=Earned Profit:
StopRobotAfter=Stop Robot After:
StopCriteria=Stop Criteria:
StartRobot=Start Robot

ShortTrack=Short Track:
LongTrack=Long Track:
Track=Track
Account=Account
TradeIdColon=Trade ID:
TimeframeColon=Timeframe:
TradingParameters=Trading Parameters:
ExitCriteriaforTrade=Closing Criteria for a Position:
ExitCriteriaforRobot=Termination Criteria for Robot:
StopRobot=Stop Robot
ClearHistory=Prepare Restart
CommentsColon=Explanation:
EditParameters=Edit Parameters

mLoggedin=Number of users logged in:
mRobots=Number of robots running:
mStopRobots=Stop all robots
mStartRobots=Start all robots
mDataConnection=Check database connection:
mConnection=Connect to database
mPriceFeed=Check if Price Feed is running:
mcPriceFeed=Connect to price feed server
mCommand=Command:
mLoxoCommand=Command
mResult=Result:
Back=Back
Performance=Performance

Summary=Summary
ConvertToStrategie=Convert To Strategy
OptimizeParameters=Optimize Parameters
ViewParameters=View Parameters
FetchingData=Fetching Data...
SaveCustomer=Save
CancelCustomer=Cancel
NotificationKey=Notifications
ViewTrackingKey=View Tracking 
UserAccountKey=View User Account
UserId=User ID:
GroupName=Group Name:
BusyMessage=Please wait...
NewCustomerCreating=A new client is being created. Please wait…
CustomerLink=Please link a user to this client.
RobotTerminationkey=Terminate all robots
StopLossBankKey=Stop outcall from the bank

ValVolumne=Please enter volume greater than zero.
ValPrice=Please enter price.
ValId=Id field cannot be left blank.
ValName=Name field cannot be left blank.
ValNoParam=Number of parameters field cannot be left blank.
ValComment=Comment is a mandatory field.
ValNoGraphs=Number of graphs field cannot be left blank.
ValIndicatoreSave=Indicator is not saved.
ValDuplicate=Duplicate Code ID.
ValCompile=Compiled successfully.
ValNumber=Numbers not allowed.
VAccountNo=Account number field cannot be left blank.
VMSAccount=Account field cannot be left blank.
VAccountNoDuplicate=No duplicate account number.
VCurrency=Currency is a mandatory field.
ValTrack=Track must be greater than 0.

BackTestAgain=Backtest Again
Exit=Exit
ParameterspastedMsg=Parameters pasted successfully.
NoResultMsg=No results found.
PasteTraderValue=Paste value into trader
BackTestResult=Backtest Result
BTInProcess=Backtest is in process.
NoOfCandleStick=Number of Candlestick
NoOfCombinationsFinished=Number of Combinations Finished
TotalCombinations=Total Number of Combinations
EstimatedTimeLeft=Estimated Time Left
TestForComplete=Test For Complete
CancelBackTest=Abort Backtest
BackTestCancelledMsg=Backtest Aborted
Wait=Wait for {0} seconds.
LongShortExpressionRequiredMsg=Please enter a Trading Strategy. Enter either a Long or a Short expression.
ParameterRequiredMsg=Please choose at least one parameter.
Test=Test
ExpressionParameters=Expression Parameters
LoopNo:=Loop Number:
Profit:=Profit (Pips):
MaxDownTurn:=Maximum Draw Down (Pips):
MaxProfit:=Maximum Profit (Pips):
MaxProfitDate:=Maximum Profit Date:
MaxDownTurnDate:=Maximum Draw Down Date:
NumberOfLongTrades:=Number of Long Positions:
NumberOfShortTrades:=Number of Short Positions:
NumberOfProfitTrades:=Number of Winning Positions:
NumberOfLossTrades:=Number of Loosing Positions:
PasteToRobot=Paste to Robot 
CopyParameters=Copy Parameters
NoRunningBackTest=There is no running Backtests found.

NameWithColon=Name:

LayoutOverride=Already exists. Do you want to overwrite?
DefaultName= Saved
EnterName:=Enter Layout Name:
SaveLayout?=Save Layout?
LoadLayoutNewWindow=New Window
ClearHistoryConfirmationMsg=Are you sure you want to clear History?
StopRobotConfirmationMsg=Are you sure you want to stop Robot?

NetExposure%= Net Exposure in %:

PartnersKey=Partners
MainMenuKey=Trading
MyAccountKey=My Account

ChangeSettingKey=Profile


AdminKey=Admin
WindowsKey=Windows
CRMKey=CRM
ViewKey=View
PartnerKey=Broker
SharedTechnologyKey=Shared Work
LogoutKey=Logout
ProfileKey=Profile
UISettingsKey=User Interface Settings
SharedInfoKey=Shared Information
EventLogKey=Event Log

RobotTradingKey=Robot Trade
MyStrategyKey=My Strategies
SharedStrategyKey=Shared Strategies
CustomIndicatorKey=Custom Indicators
CustomerDetailsKey=Clients
GroupDetailsKey=Groups
ManageUserKey=Users
PartnerManageUserKey=Partners
UserTrackInfoKey=User Tracking Info
RunningRobotKey=Robots Status
LimitOrders=Limit Orders
ManagementKey=System Overview
RunningBacktestkey=Backtests Status
SavelayoutKey=Save Layout
LoadlayoutKey=Load Layout
ClearSavedKey=Clear Saved
CloseAllKey=Close All Documents  
OpenAllKey=Open All Documents
TradingStrategyKey=Trading Strategy
AccountKey=Accounts
TradingSymbolsKey=Trading Symbols
CleanUpKey=Clean Up
WelcomeKey=Welcome
CleanupInvalidDateMessage=Please select a valid date
ClenupLogsSuceessMessage=You have successfully cleared the logs. 
CleanUpLogKey=Clean Up Event Log
CleanUpTrackingKey=Clean Up Tracking
CleanUpRobotKey=Clean Up Robot Log
CleaningLogMessage=Are you sure you want to delete all the logs older than {0}?
CleaningTrackMessage=Are you sure you want to delete all the Tracks older than {0}?
CleaningRobotMessage=Are you sure you want to delete all the Robot logs older than {0}? 
SharedStrategiesKey=Shared Strategies

BusyIndicatorLoggingIn=Logging in
BusyIndicatorRegisteringUser=Please wait.....
BusyIndicatorSavingSettings=Saving your settings....
LoginIdExists=This Login Id already exists. Enter a new Login Id.
AccountExpireMessage=, your account has expired.
AccountCloseMessage=, your account has been closed.
LoginErrorkey=Login failed. Please try again.
LoginId=Login ID:
LoginPassword=Password:
ConfirmPassword=Confirm Password:
LoginName=Name:
LoginEmail=Email:
SecurtyQuestion=Security Question:
GuestRegistration=Create Demo Account
GuestUserReg=Guest User Registration Form
GuestUserInfo=Guest User Information
GuestLoginInfo=Guest Login Information
Answer=Answer:
UserSettingsheader=Please complete all mandatory fields to modify your account.
Task=My Tasks:
Tasks=Tasks:
Status=Status:
Role=Role:
Email=Email
PriceCategory=Price Category:
CustomerType=Client Type:
NewuserHeading=Create New User
GeneralSetings=General Settings
SLLBeginning=Save and load layout on exit and start up
DisplayTime=Display Time as:
Themes=Themes:
DGPageSize=Number of grid lines in chart:
ChartSettings=Chart Settings 
HeikinAshi=Heikin-Ashi
Standard=Standard
DefaultCandleStick=Default Candlestick
Language=Language:
CandleStickType=Candlestick type:
AggCandleStick=Aggregate candlesticks?
AggregationLimit=Aggregation Limit:
TrdChrtSettings=Trading Chart Setting
NotcPoints=Number of trading chart points:
LocalTime=Local Time
UtcTime=UTC Time
DarkTheme=Dark theme
LightTheme=Light theme
CandleStickSetting=Candlestick
OHLC=Ohlc
Yes=Yes
No=No
LeavePosition=Leave Position Open

WizardWelcome=Welcome to the Expression Wizard
WizardWelcomeDesc=You have created a graph in the left side of the screen. The graph comprises of prices and indicator values.#In the expressions, you can select any of the given values and compare them against each other. When you compare the values, either the expression becomes TRUE or FALSE. #When expression "Open Long" becomes TRUE, LiveChartTrader buys a long position. When expression "Close Long" becomes TRUE, LiveChartTrader sells that position, and likewise for Open/Close Short.
WizardIndicator=You can now pick a value from one of the indicators.#In "Period" enter "How many periods ago" the indicator value is. 0 is most recent value. 1 is the previous value. 8 is the indicator value 8 periods ago.
WizardPrice=You can now pick a price from one of the symbols.#In "Period" enter "How many periods ago" the price is. 0 is most recent price. 1 is the previous price. 8 is the price 8 periods ago.
WizardFixed=You can compare a price or an indicator value against a fixed value. Enter the fixed value here.
WizardDate=By using dates, you can make your strategy active at a certain time of the day. You should only use dates in "Open" expression.
WizardParameter=You can compare a price or an indicator value against a user input value. This is more flexible than using a fixed value.#Please note that the parameters first should be created in the tab "Parameter".
WizardSystem=In System functions, you can access all kind of information about the status of your trading robot.
WizardType=An expression always has a left side and a right side and a comparison operator in the middle. The left and right side can be any of the types.#Select which type of value this side should be:
WizardComparison= Select a comparison operator between the left side and the right side of the expression.
WizardFinish=This text will now be inserted into the expression box. You can edit the text, and insert numbers and operators +-*/&(and)|(or).#You can locate the cursor at any place in the text box and use this wizard again to insert one more expression.#You can also delete the text in the box and start all over again.
Date=Date
FixedValue=Fixed Value
Parameter=Parameter
Math=Math
lblMath=Math:
WizardMath=We have a library of math functions.#Some function like Abs, Cos, Sqrt takes one parameter; Abs(MA.MA)#Some function like Min, Max, Pow takes 2 parameters; Max(Price.Close, Price.HaClose)
lblFunctions=Apply Function:

Error=Error
OperationUnsuccessfulMsg=Operation cannot be completed.
CouldNotDelete=Item cannot be deleted.
CouldNotLoad=Data could not be loaded.
AccountDoesNotExsist=Account Does Not Exist.
UserDoesNotExsist=User Does Not Exist.
CouldNotSave=Data could not be saved.
Exception=There is a problem when performing this operation.
NoRights=You are not authorized to do this operation. 
NoSucces=Operation unsuccessful.  
UserNotLoggedIn=You are not logged in. Please login to continue. 
RobotIsAllreadyRunning=Robot is already running.
TrackTooSmall=Track is too small.
TrackUsedByAnotherRobot=Track is already used by another robot.
VolumeTooSmall=Volume is too small.
CouldNotStartRobot=Could not start robot.
RobotIsStillUpdating=Robot is still waiting for the order confirmation. Please wait while it clears history.
UserAlreadyExists=This Login Id already exists. Enter a new Login Id.
UserCreationFailed=The User creation operation has failed. Please try it again.
ErrorMsgOnLineNumber=Error on line number:
VolumeNotInMultipleOfMinVolumeMsg=Volume should be in multiple of Minimum Tradeable Volume.

UAccount=Account:
UCurrency=Currency:
UCreate=Create Account
OpenInitialOrderMsg=Robot has been started successfully. What do you want robot to do:
FirstPosition=First Position
RobotPosition=Robot Position
AddPartner=Assign User to Partner
DeletePartner=Remove Assigned Partners
Partner=Partner
ViewAddedPartners=Show Assigned Partners
PartnerDeleteMsg=Partners deleted successfully.
PartnerAddedMsg=Partners added successfully.
UsersWithoutPartners=Users without Partners
OpenPositionNow=Open a position now
WaitForNextCycle=Wait until next trading cycle
DeleteUser=Delete User
ModifyUser=Modify User
DeleteUserMessage=The selected user has been deleted successfully.
ChangePasswordMessage=The password has been changed successfully.
BackendClientIdMessage=The backend client Id has been assigned successfully.
CreateUserMessage=The user has been created successfully.
UserInfoKey=User Information
LoginInfoKey=Login Information
IsDeleteUserMessage=Are you sure you want to delete the selected user?
CustomerManagement=Clients
PartnerManagement=Clients
HisLivechartTrader=His Straticator

InstallOnComputer=Install on this Computer
RemoveOnComputer=This application is already installed on this computer. Press the right-click on your mouse, select "Remove this application" and then click the "Yes" button to uninstall it from the computer. 

TSSymbols=Symbol:
TSActive=Active:
TSDecimals=Decimals:
TSCategories=Categories:
TSQuotesize=Quote Size:
TSSpread=Spread:
TSSymbolType=Symbol Type:
TSImport=Import Symbols
TSID=ID:
TSName=Name
TSTradingType=Trading:
VTSID=Id field cannot be left blank.
VTSName=Name field cannot be left blank.
VTSSymbol=Symbol field cannot be left blank.
VTSDecimals=Decimals field cannot be left blank.
VTSQuotesize=Quote Size field cannot be left blank.
VTSCategories=Categories field cannot be left blank.
VTSDuplicate=Duplicate Symbol
VTSValidSymbol=Please enter valid currency pair.
VTSSpread=Spread field cannot be left blank.  
Notifications=Notifications
ConfirmMessage=Are you sure?
InvalidParameter=Invalid Parameter Value
NotificationToolTip=New Notification. Click to View it.
FavouriteKey=My Favourite
AboutKey=About

BadUNamePwrdMessage=The user name or password is incorrect.
LoginFailedMessagekey=Login failed. Please try again.
MandatoryMessage=All fields are mandatory. Please fill in all the corresponding fields. 
MandatoryField=This is a mandatory field.       
TradingPermission=You don't have permission for trading.
VCommon=Please enter valid value.
DemoMode=Demo Mode:
VFavourite=There are no favourite symbols. To make a favourite symbol, click "Symbols" under "My Account" menu, then double-click the check box (under the "Favourite" column) against the symbol you want to make favourite, and click the OK button to save changes.
AddGroup=Create Group
DeleteGroup=Remove Group
PriceType=Price Type:

From=From
To=To
CurrentValue=Current Value
Step=Step
System=System
BackTestStepIncreasedInfo=Info: Due to more than 100.000 combinations in the backtest, the ‘step’ has been increased to reduce the number of combinations.
SavingInputs=Saving Inputs
StrategySaved=Strategy has been saved successfully.
Message=Message
SL/TP=SL/TP
TrackInfoClearMsg=You have successfully cleared all the older TrackInfos before
LogClearMsg=You have successfully cleared all the older Logs before
UnhandledException=The Server has encountered a problem ! Please try after some time.
BackendClientIdRequired=Please enter Client Id to continue.
UserRequiredKey=Please select a user to continue this operation. 
UserPasswordChage=Your password has changed. Please login again
BulletType=Bullet Type
FillGraph=Fill Graph
LoginWindowTitle=Straticator Login System
DefaultSymbol=Default Symbol:
SaveExit=Save & Exit
TradingChartPointMsg=Required number of trading chart points between 30 to 300.
PageSizeNumeic=Page size should be numeric.
PageSizeLimit=Page Size should not be less than 20 .
LoginIdWhiteSpace=Please do not use white spaces in Login ID.
GuestUserRegFailed=The Guest user could not be created. Please try again.
SlUpdate=Update Available, please restart/reopen to apply changes.
SlApplicationUpdate=An application update is available, but it requires a new version of Silverlight. Visit Microsoft site to upgrade.
KeyExisteMsg=Hey!the key '{0}' you have added already exists.
ChangePasswordkey=Change Password
GenerateBackendClientIdkey=Assign Client ID
EmulatedTransactions=Transactions
StopLossBankMessage=The bank has stopped out all open positions. This operation will terminate all robots and not make any trades, since the bank has closed all positions
RobotTerminateMessage=This operation will terminate all robots and close all open positions
Start=Start
OptimizationStrategy:=Optimization Strategies:
Optimization=Optimization
PeriodFrom=Period From
PeriodTo=Period To
AssignBCIDKey=Assign Backend Client ID.
BackendClientId=Backend Client ID:
MarketClosed=Market is Closed
CleanUpNotification=Clean Up notification
CleaningNotificationMessage=Are you sure you want to delete all the notifications older than {0}? 
NotificationClearMsg=You have successfully cleared all the previous notifications 
ReferenceDate=Reference Date
LeftReference=Left side of Graph
FirstReference=First date in Chart
LastReference=Last date in Chart
BetweenReference=Date between first and last date
BackTestError=There is an error in the backtest. Backtest was aborted.
BackTestAborted=Backtest has been aborted.
UserIdSplChrMsg=The Login ID should not contain any Special characters. 
AvoidWhiteSpaceMsg=Please don't use whitespaces in Login ID
LoginIdlength=The Login ID should contain atleast 3 characters

ViewStrategicReport=Strategy Report
SRPrintPreview=Print Preview
SRParameterName=Parameter Name
SRPrompt=Prompt
SRInputMask=InputMask
SRValue=Value
SRParameters=Parameters:
SRValidateXML=Error reading in XML file!
SRXMLVersion=This xml version is not supported.
KeepRunning=Keep Running and Exit
KeepRunningMessage=Backtest will continue to run. Please view the result in menu View/Backtest Result.
GraphWindow=Graph Window
Decimals=Decimals
Id=ID

STTradeId=TradeId
ModifiedOn=Modified On
Running=Running
GHLoginId=LoginID
CodeID=CodeId
Use=Use
Favourite=Favourite
NotificationType=Notification Type
NotifiedOn=Notified On
CreatedBy=Created By
Demo=Demo:
Uid=User ID
NumberOfTrades=Number Of Trades
Iterations=Iterations
OpenVolume=Open Volume
OpenPrice=Profit(USD)

Ticks=Ticks
Second=Seconds
Minute=Minutes
Hour=Hours
Day=Days
TimeFrames=Seconds#Minutes#Hours#Days
TimeFramesOne=1 Ticks#1 Minute#1 Hour#1 Day
TimeframeTitle=Enter candlestick time frame
VTime=Please enter the time.
TradingGraph=Trading Graph 
Smoothing=Apply function
Method=Method
NumberOfPeriod=No Of Periods
UseIncompleteCandlestick=Use incomplete candlestick
RememberMeKey=Keep me signed in
Import=Import
WelcomeMessage=Welcome {0}
PasswordRecoveryWindowsTitle=Recover Password
WelcomeMessageQueryString=Admin view on : {0}
Help=Help
PersonalIndicator=Personal Indicator
RobotSaved=Robot has been saved successfully.
ChangeUserInfo=Change profile
VCreateRobot=Please select a strategy.
ReloadRobot=Reload Strategy
ReloadRobotMsg=The robot takes a copy of the strategy, when it is created.If the strategy is modified, the robots is not affected. You can reload the modified strategy into the robot. Are you sure you want to do that?
TerminationStrategy=Termination Strategy
Manual=Manual
OpenClose=After Open and Close
Open=After Open
StrategyNotFound=Strategy does not exist.
TerminationReason=Termination Reason:
Mode=Mode:
Trade=Trade:
Live=Live
LongPlusShort=Long + Short
LongOnly=Long Only
ShortOnly=Short Only
BackTestRange=Backtest Range
OptionalRatio=Optional Ratio
StartTimframe=Start Timeframe
EndTimeframe=End Timeframe
NumberOfSteps=Number of steps
FixedSpread=Fixed Spread
Optimize_All=Optimize All
Optimize_Parameters=Optimize Parameters
Optimize_SLTP=Optimize SLTP
No_Optimization=No Optimization
NewStrategy=New Strategy
NumberOfRobots=Number of robots
BackTestResultKey=Backtest Result
EditUser=Edit User
Actions=Actions
RunningBackTestsKey=Running Backtests
AdManagementKey=Management

EnumPriceType=Mix#Ask#Bid
MarketType=Market#Quoted#Limit#Buy/Sell Stop#Take Profit#Stop Loss#Trailing Stop Loss
EnumUserOrderOrigin=Manual#Robot#Trade#Stopout#Manager Follow#MT4#API#Manager Manual#Broker Correction#Mobile#FIX
EnumUserOrderArchieveStep=Traded#Modified#Cancelled#Cancel Related#Cancel Stop Out#Cancel Neutral Position#Expired#Rejected#Cancel Exceed Margin#Cancel Increase Position#Cancel OTO#Pending
DurationType=Good til Cancel#End of Day#End of Week#Immediate or Cancel#Fill or Kill#Time Frame
DurationShort=GTC#Day#Week#IOC#FOK#Time
Order=Order
History=History
EnumCustomerType=Amateur#SemiPro#Professional#Institutional
EnumUserTasks=Manual Trading#View Strategies#Edit Strategies#View Indicators#Edit Indicators#View Robots#Edit Robots#Operate Robots#View Transactions#Add Account#Change Leverage Group#Edit Shared Info#Edit Profile#Copy Trader Master, Manual Trade on followers#Copy Trader Master#Kill Backtest#View Admin#Edit Admin#View Broker Setup#Edit Broker Setup#View User Data#Edit User Data#View User#Edit User#Trade On User Accounts#Enter Deposits#Copy Trader Master Public#Choice Liquidity##Admin#Broker#Master Broker
EnumUserStatus=Open#Blocked#Deleted
EnumUserRoles=Guest#Trader#Professional#Institutional#Broker#Admin
ExtendGuestAccount=Extend Guest account
ExtendGuestAccountMessage==={0} 's guest account was extended successfully.Please notify the user about the extension,so that he/ she can continue to work.
GuestAccountExtensionNotNeeded==={0} 's guest account is already full. It doesn't need extension now.
UpdateTimeFrameKey=Update Timeframe
OperationSuccessfulMsg=Operation completed successfully.

AveragePrompt=Average Method
SmoothingPrompt=Smoothing Method
PeriodPrompt=Number of Periods
CandlestickPrompt=Candlesticks Used
PricePrompt=Prices used
AverageTooltip=Select method to be used to generate the smoothing average
SmoothingTooltip=Select the smoothed method to be used of the Average Method
PeriodTooltip=Numbers of bars used for the calculation
CandlestickTooltip=Select which candlestick to be used for the calculation
PriceTooltip=It is high and low prices or the selected working price used to calculate the indicator
MaxPricePrompt=Max Price Changing (pips)
MaxPriceTooltip=The maximum price changing during trade session
StartAccPrompt=Start
StartAccTooltip=The initial acceleration factor
StepAccPrompt=Step
StepAccTooltip=The acceleration step factor
MaxAccPrompt=Maximum
MaxAccTooltip=The maximum acceleration factor
ShiftPrompt=Shift
ShiftTooltip=Number of bars the price should be plotted to the right
LipsPrompt=Number of Lips Periods
TeethPrompt=Number of Teeth Periods
JawsPrompt=Number of Jaws Periods
ATRPrompt=ATR Periods
MAPrompt=MA Periods
CoefficientPrompt=Coefficient
CoefficientATRTooltip=The Average True Range (ATR) will be multiplied with this factor
ForecastPrompt=Forecast
ForecastTooltip=Number of bars the Linear Regression should be forecasted
CMPPrompt=Chande Momentum Periods
CMPTooltip=Number of bars used in Chande Momentum Oscillator (CMO)
OffsetComparePrompt=Offset to compare with
FastLimitPrompt=Fast Limit
FastLimtTooltip=If the phase rate of change is negative or small, the value of alpha is set to the Fast Limit
SlowLimitPrompt=Slow Limit
SlowLimitTooltip=If the phase rate of change is large, the value of alpha is set to the Slow Limit
SmoothReducePrompt=Smooth Reduce factor,G
SmoothReduceTooltip=Number of times that the smoothing constant is multiplied with itself to reduce its effect
 FastPeriodPrompt=Fast Period
 SlowPeriodPrompt=Slow Period
 SPNumberPrompt=Number of Short Periods
 LPNumberPrompt=Number of Long Periods
 SignalPeriodPrompt=Number of Periods in Signal
 %KPPrompt=%K Periods
 %DPPrompt=%D Periods
 AvgPPrompt=Average Periods
 BPPrompt=Base Price
 MULPrompt=Margin Upper Level
 MLLPrompt=Margin Lower Level
 PipsDeviationPrompt=Deviation in pips
 PipsDeviationTooltip=How many pips is needed to signal a difference in price
 TSPrompt=Trend Strength
 PatternPrompt=Pattern
 SSPPrompt=Stochastics Smooth Periods
 SwingBarsPrompt=Bars on swing point
 SwingBarsTooltip=Number of bars required on each side of the swing point
 SignalPrompt=Signal 
 BandDeviationTooltip=The Standard Deviation (stddev) will be multiplied with this factor
 BandDeviationPrompt=Band Deviation
 LookBackLength=Look back bars
 LookBackLengthTooltip=How many bars back should be looked at, to determine new direction
 
SecInTimeFrame=Seconds in Timeframe
Flag=Flag
TFId=TFId
PriceVolume=Price*Volume
SSymbol=Select Symbol:
SRobot=Select Robot:
EnumBackTestMethod=Best Iteration Profit#Best End Profit#Smallest Draw Down With Best Iteration Profit#Smallest Draw Down With Best End Profit#Best Iteration Profit Draw Down Ratio#Best End Profit Draw Down Ratio#Best Iteration Profit Draw Down Optional Ratio#Best End Profit Draw Down Optional Ratio#Most Profitable Trades#Most Profitable Trades Ratio
FilterTitle=Search
RefreshTitle=Clear Search
Expired=Expired On
AddBroker=Add Broker
NewTradingSymbol=New Trading Symbol
SymbolID=Symbol ID:
RecordAlreadyExists=The record already exists. Please try it with another one again.
Brokers=Brokers
BrokerName=Broker name
BrokerId=Broker ID
BrokerFlag=Flag 
BrokerCreatedMsg=Broker successfully created.
BrokerUpdatedMsg=Broker successfully updated.
PriceMarkUpGroups=Price Markup Groups
PMGId=PMGId
AddPMG=Add Price Markup Group
PMGCreatedMsg=The Price Markup Group was successfully created.
PMGUpdatedMsg=The Price Markup Group was successfully updated.
GoToError=Go To Error
PMGName=Price Markup Group Name
MarkUpKey=Price Markups
SaveAllKey=Save all
Markup1Key=Markup 1
Markup2Key=Markup 2
Markup3Key=Markup 3
Markup4Key=Markup 4
MarkupLevel1Key=Markup Level 1
MarkupLevel2Key=Markup Level 2
Markuplevel3Key=Markup Level 3
fee1Key=Fee 1
fee2Key=Fee 2
fee3Key=Fee 3
fee4Key=Fee 4
FeeLevel1Key=Fee Level 1
FeeLevel2Key=Fee Level 2
FeeLevel3Key=Fee Level 3
ShortInterestKey=Short Interest
LongInterestKey=Long Interest
PricemarkupCreatedMsg=The Price markup details were successfully Saved.
PricemarkupSaveFaileddMsg=The Price markup details were not saved. Please try again.

SellOrder=Sell Order
TPOrderId=TPOrderId
SLOrderId=SLOrderId
HOpen=Open
InMarket=In Market
ClosePrice=Close Price
DeltaPrice=Delta Price
Pips=Pips
SumProfit=Sum Profit
PctOfProfit=PctOfProfit
SumPips=Sum Pips:
Action=Action
MarkupExplanation1=a.Markup is in pips.
MarkupExplanation2=b.Fee is in the quoted currency for the symbol.
MarkupExplanation3=c.Markup Level and fee level is Volume for the symbol.
MarkupExplanation4=d.Interest in annual %. 1/360 is used per day. Positive number will mean that the user pays interest, Negative number means that the user earns interest.
LeverageGroup=Leverage Group
CreateLeverage=Create Leverage Group
LGId=Leverage Group ID:
MarginCall1=Margin Call 1:
MarginCall2=Margin Call 2:
MarginCall3=Margin Call 3:
StopCall=Stop out call:
MaxEntryMargin=Max Entry Margin 
AccountTransactionKey=Account Transaction
LeverageName=Leverage Name:
VersionUpdateKey=Update Version
UpdateAidKey=Update Robot Account Id
Profit=Profit
TerminatedReason=Terminated Reason
OpenPosition=Open Position
TotalTradingVolume= Total Trading Volume
Equity=Equity
AmountInvested=Amount Invested
PL=P/L
PLSum=P/L Sum
MarginUsed===% Margin Used
BrokerInfoKey=Broker Information
BrokerHeaderKey=Broker :
Aid=Account ID
Oid=Order Id
ExternalId=ExternalId
SL=S/L
TP=T/P
RelatedOid=Related Order Id
OrderOrigin=Order Origin

clientAccount=Client Account
brokerAccount=Broker Account
tradeAccount=Trade Account
BrokerAccounts=My Accounts
AllFieldsMandatory=All fields are mandatory.
Deposit=Deposit
Withdrawal=Withdrawal
Correction=Correction
BrokerAccountKey=Broker Account
SelectPMGKey=Please select a Price Markup Group to continue
PMGHeaderKey=PMG ID :
NationalityKey=Nationality :
NationalityHeader=Nationality

MaxLeverage=MaxLeverage
Leverage=Leverage
Statement=Statement
Trades=Trades
LoginId/Account=LoginID/Account
Slippage=Slippage:
TransactionType=Transaction Type
Total=Total
AccountType=Account Type
AccountDetails=Account Details
AccountName=Account Name:
CurrencyWith3=Currency (Must be in 3 letter):
AccountBalance=Account details
CurrentPrice=Current Price
RealizedPL=Realized PL
ManageUserAccountBalanceKey=User Account Balance
ManageLiveUserAccountBalanceKey=User Account Balance.Live
ManageDemoUserAccountBalanceKey=User Account Balance.Demo
NumberInUSD=All numbers are in USD
StEndDateValidationKey=Start date should be less than End date .
TradingDetails=Trading Details for {0}
GetLogs=Get logs
UserDefinedLeverage=User defined leverage:
UserDefinedStop=User defined stop out:
DefineLeverage=Define Leverage
UserLeverageDesc=You can define you own leverage, which is less to what the broker gives you.This way you can control that you do not leverage your equity too hard.
DepositOnDemo=Deposit on Demo
IsDefault=IsDefault
DefaultWarningMsg=Do you want to change your default leverage group?


AccountTransactionsKey=Account Transactions
LinePostedSuccessfully=Line has been posted successfully
Success=Success
UserDefinedLeverageMSG=Please enter valid value between 0 to 500.
RobotMenuKey=Robot
SettingsKey=Settings
OrderMenuKey=Active orders

FromTrack=From Track:
ToTrack=To Track:
DemoHeader=Demo
RiskBookKey=Risk Book
MaxLongExposure=Max Long Exposure
MaxShortExposure=Max Short Exposure
OrderQuantity=Order Quantity

SelectAccount=--Select Account--
SelectAccountMsg=Please select Account
ExposureKey=Exposure

TradeTransactionKey=Trades and Transactions
RecordsAreUpdatedKey=Records are updated Successfully.
OriginOidKey=Origin Order Id

OrderStatus=Order placed successfully.
CreateSymbol=Create Symbol
ErrorinLimitprice1=Error in Limit-price. Price has to be smaller than 'Buy-price'.
ErrorinLimitprice2=Error in Limit-price. Price has to be larger than 'Sell-price'.
ErrorinLimitprice3=Error in Limit-price. Price has to be larger than 'Buy-price'.
ErrorinLimitprice4=Error in Limit-price. Price has to be smaller than 'Sell-price'.
BrokerAccountsKey=Broker Accounts
TradeConfirmation=Trade Confirmation:
OrderConfirmation=Order Confirmation:
UseTrackskey=Use Tracks:
WouldExceedMargin=Order will exceed margin. Order rejected.
WouldExceedMarginSymbol=Order will exceed margin for the selected symbol. Order rejected.
CouldNotChangeValue=Value can't be changed.
ValidateIsDefault=You already have a default account.{0}Do you want to make this account the default account?
AccountingKey=Deposit and Withdrawal
SetLimitKey=Set Limits
SetupKey=Setup
StatementType=Statement Type
Balance=Balance
BrokerMissmatchMessage= You can't login! Brokers missmatched. Please contact Admin.
AccountNameKey=Account Name
BankNameKey=Bank Name
BankBICKey=Bank BIC
BankLocationKey=Bank Location
BankKodeKey=Bank Code
IBANKey=IBAN
NationalBankAccountKey=National Bank Account
LinkToOnlineTransferKey=Link To Online Transfer
ExchangeFeePctKey=Exchange Fee Pct
FIXViewKey=FIX
OpenPrices=Open Price
EnumTransactionType=Deposit#Withdrawal#Correction#Internal Transfer#Fee#Interest#Realized PL#Unrealized PL#Balance#Roll Over#Primo Equity#Ultimo Balance#Unrealized PL Total#Ultimo Equity#Trade Exit#Trade Entry
InvalidDataMessage=Invalid data entered for the field {0}
AssignFIX=Assign FIX
MinTradingVolume=Min Trading Volume
CurrencyId=Currency ID
AddFIX=Add FIX
BrokerErrorMesages=Please enter Broker name.#Please enter Address 1.#Please enter Email.
SelectCountryKey=Select Country
EmaiValidationKey=Please enter the Email.
CountrySelectKey=Please select a Country.
LoginIdRequired=Please enter Login ID.
LiveAccount=Live Account
DemoAccount=Demo Account
EmailFormatkey=Please enter Email Id in correct format.
EnumDemoMode=Live Account#Demo Account#Test#Signal
FIXNameKey=FIX Name
VersionKey=Version
IPAddressKey=IP Address
PortKey=Port
SenderSubIDKey=SenderSubID
SenderCompIDKey=SenderCompID
TargetCompIDKey=TargetCompID
TargetSubIDKey=TargetSubID
FlagsKey=Flags
DemoDepositMsg=Do you want to make a free deposit on your Account?
TransferTextmsg=In the text field on the transfer you write:
DepositCurrencyMsg=The deposit should be made in currency:
DepositInstructions=Deposit Instructions
ValidateFIXName=FIX Name field cannot be left blank.
ValidateVersion= Version field cannot be left blank.
ValidateVersionLength=Version field can contain only valid Value (4.1 etc).
ValidateIP= IP Address field cannot be left blank.
ValidatePort=Port field cannot be left blank.
ValidatePortValue=Please enter a valid value inside port field.
ValidateSenderSubId=SenderSubID field cannot be left blank.
ValidateSenderCompId=SenderCompID field cannot be left blank.
ValidateTargetCompID=TargetCompID field cannot be left blank.
ValidateTargetSubId=TargetSubID field cannot be left blank.
ValidateUserName=User Name field cannot be left blank.
ValidatePassword=Password field cannot be left blank.
ValidateAccount= Account field cannot be left blank.
ValidateFlags=Flags field cannot be left blank. 
EditFIX=Edit FIX

BrokerAccountTradeKey=FIX Trades
TradeStatus=Trade Status
ViewTransactionsKey=View Transactions
CurrencySymbol=Currency Symbol
NumberOfLimitOrders=Number Of Limit Orders
ActMarginNotification=Account {0}:'{1}'. Margin is now {2}%
ActPosClosedMarginNotification=All positions closed on Account {0}:'{1}'. Margin is now {2}%
WarnMargin=Account {0}:'{1}'. Margin is now {2}%, Stopout at {3}%
WarnMarginSymbol=Account {0}:'{1}'. Margin is now {2}% for Symbol={4}, Stopout at {3}%
WarnStopout=All positions are closed on Account {0}:'{1}'. Margin is now {2}%, Max allowed {3}%
WarnStopoutSymbol=Positions on Symbol={4} are closed on Account {0}:'{1}'. Margin is now {2}%, Max allowed {3}%
OrderExceptionNotification=Exception PlaceOrder. ID={0}-{1}, Ex={2}
ConfirmRegistrationUser=Your Account has been created. Please login with your Login ID and password.
LeverageFactor=Leverage Factor:
LeverageFactorMsg=Leverage Factor field cannot be left blank.
AddIdMsg=Please add {0} ID.
OrderFailedStatus=Order is not placed.
Permission=Permission
Exceptionheader=Exception
Invalid=Invalid
Duplicate=Duplicate
MinVolumeMsg=Volume must be greater than {0} and multiple of {1}.
BackendClientkey=Backend Client
ExternalAccount=External Accounts
InvalidVolume=Invalid Volume value.
RollOverKey=Roll Over
RunRolloverFor=Run RollOver For
Run=Run
RollOverConfirmation=Are you sure you want to run rollover!
RollOverRunSuccessfully=RollOver Run successfully!
Exist=Exist
Empty=Empty
UploadFileKey=Please select a file to load
Failed=Failed
Robot=Robot:
ExpressionEditor=Expression Editor
More=Editor
Row=Line:
Column=Position:
Syntax=Syntax
EnumTradingSymbolType=Forex#Forex_Related#Index#CFD#Stocks#Futures
EnumTradingType=Long + Short#Long#Short#No Trading
RecoverPassword=Recover Password
ForgotPassword=Forgot Password?
EmailSentMsg=Your password has been sent to the Registered Email Address.
InvalidLoginId=Login ID does not exist.
TradeVolumeKey=Trade Volume Report
NegativePrice=Sell Value
PositivePrice=Buy Value
NegativeVolume=Sell Volume
PositiveVolume=Buy Volume
HourlyVolumeTrade=Hourly Buy/Sell Volume
Send=Send
BankReconciliation=Bank Reconciliation
PostChanges=Post Changes
CorrectedValue=Correct Value
UpdatedValuesMsg=Values Updated.
UseRiskBook=Use Risk Book
Address1=Address1
Address2=Address2
Address3=Address3
EnumYesNo=No#Yes
VolumeOnBook=Volume On Book
RiskMaxLongExposure=Max-Long
RiskMaxShortExposure=Max-Short
ReduceExposure=Reduce Exposure
ZeroExposure=Zero Exposure
BrokerAcctTradeOriginEnum=Automatic#Manual
ManageRiskbook=Manage Riskbook
Difference=Difference
LoginReport=Login Report
LastTimeLogIn= Last Time Login
FIXid=FIX ID
Include=Include
TradingType=Trading Type
FIXSymbols=FIX Symbols
RobotOrderRejected=Robot Order Rejected. RobotId={0}, Explanation={1}.
ManualOrderRejected=Order Rejected. OrderId={0}, Explanation={1}.
ActiveKey=Approved
EnumEnableDisable=Disable#Enable
AssignFixAccount=Assign Fix Account
FixAccounts=Fix Accounts
FIXColon=FIX:
EditSymbols=Edit Symbols
ViewSymbols=View Symbols
LoginIdEmail=Login ID/Email:
CreateNew=Create New
TradeSell=On OrderId={0} You sold {1} of {2} at {3}
TradeBuy=On OrderId={0} You bought {1} of {2} at {3}
TradeSellAc=On Account={0} You sold {1} of {2} at {3} OrderId={4}
TradeBuyAc=On Account={0} You bought {1} of {2} at {3} OrderId={4}
AllSymbolsKey=All symbols
ForexKey=Forex
CFDKey=Commodities
IndicesKey=Indices
MetalsKey=Metals
MoneyManager=Copy Trader Master
Portfolio=Portfolio
Description=Description
TradeConfirmationInfo=Trade Confirmation: Type={0} {1} Volume={2} at Price={3}, Time={4}, OrderID={5}, Account={6}
OrderConfirmationInfo={0} Order ID ={1}, Account={2}
PhoneNo=Phone No:
selectCode=Code
selectCountryCode=Please select your country phone code
ValidatePhoneNo=Please enter a valid Phone no
EnumActivePortfolio=Active#AllUsers#ApproveFollowers
Pending=Pending
AddPortfolio=Add Portfolio
Create=Create
Followers=Followers
LeverageForex=Forex Leverage:
LeverageMarginCall=(% of total leverage)
LeverageForexRelated=Related Forex Leverage:
LeverageCFD=Commodities Leverage:
LeverageIndex=Index Leverage:
LeverageStocks=Stocks Leverage:
LeverageFutures=Futures Leverage:
ForcePasswordChange=Force Password Change
PMGIdRobot=PMGId Robot
LMGId=LMG ID
BackendClient=Backend Client
LeverageNameErrorMsg=Leverage name required.
AccountMoneyManagerAlreadyExists=Only one CTM per Account is allowed. Create new account in Straticator or contact Support.
AllUsers=All Users
ApproveFollowers=Approve Followers
Approved=Approved
InstantFollow=Instant Follow
StartupScreen=Startup Screen
FollowMoneyManager=Follow Copy Trader Master
Website=Website
CommonLeverageErrorMsg=Please enter valid value.
MarkupGroupNameErrorMsg=Price markup group name required.
ShowStartup=Show widgets at startup
MarginUsedAmount=Margin Used Amount
DescWFavouriteSymbols=Be updated with the market price of your favourite symbols
DescWRobotsStatus=Shows you the status of your robots
DescWNotifications=It will keep you updated with your latest notifications
DescWCurrencyExposure=It will keep you updated with your currency exposure
DescWSymbolExposure=It will keep you updated with your symbol exposure
DescWPrices=It will show you the latest prices
DescWMyAccounts=Get your accounts list
LeverageErrorMsg=Please select leverage.
MaxEntryMarginErrorMsg=Max Entry Margin should not be greater then 100.
AddFollowers=Add Follower
LeveragePercentErrorMsg={0} should be greater than {1}.
EditFieldAndvalue=The field "{0}" is edited and set to a new value="{1}".Do you accept ?
SpreadMarkup=Spread Markup
PriceMarkup=Price Markup
BrokerSymbolsKey=Broker Symbols
ExploreWidget=Explore and customize page by choosing from list of widgets available
MoreWidget=More>>
ManageWidgets=Manage Widgets
MasterBrokerId=Master Broker ID
WidgetExists=You already have this widget.
DescWMyChart=Customize your chart
PriceFix=Price FIX
EnumTradePrice=Trade#Price
FavoritesKey=Favorites
Warning=Warning
RBNotEnabled=Riskbook is not enabled
DefaultPrintingPrice=2-digits highlight price printing
SymbolNotTradeAble=Symbol is not Tradeable
QuoteNoLongerValid=Quote is no longer valid
PricesNotValid=The prices are not updated, so quotes are not valid.
ConnectionNotRunning=The connection to the liquidity provider is not running. Order rejected.
QuickTradeKey=Quick Trade
QuickTradeSymbols=Quick trade all symbols
QuickTradeForex=Quick trade forex
QuickTradeForexRelated=Quick trade metals
QuickTradeIndex=Quick trade Indices
QuickTradeCFD=Quick trade Commodities
QuickTradeFavorites=Quick trade favorites
ProfitLossReport=Profit-Loss Report
MasterBrokerPriceMarkup=Price Markup from Master Broker
TotalRiskBook=Run total Riskbook
GlobalOverNightInterest=Overnight Interest from Global Setup
LongInterest=Long Interest:
ShortInterest=Short Interest:
MinPctMarkupClient=Minimun Pct Markup for Clients
MinPctMarkupBroker=Mininum Pct Markup for the Broker
Revenue=Revenue
ActiveFollowed=Active Followed
WhatToFollow=What to follow
Follow=Follow
ShowPerformance=Show Performance
MergeAccount=Merge Accounts
Goingforward=Merge into:
DeleteAccount=Delete account:
MergeAccountError=Account merging are not valid!
UnrealizedPL=Unrealized PL
CustomerEmail=Client Email:
BrokerProfit=IB Profit
AmountCur=Amount Account Currency
WidgetAdded=Widget has been added successfully.
FollowerAdded=Follower created successfully.
FastPriceUpdate=Fast price update
MarkupGroupName=Markup Group Name:
UserGroup=User Group:
SalesPerson=Sales Person
AddSalesPerson=Add Sales Person
SPID=SPID
SalesPersonName=Sales Person Name:
Select=<--Select -->
UserPricesAndMarkupKey=User prices and markup
UserAsk=User Ask
UserBid=User Bid
Markup=Markup
DescWFollowedMM=Keep track of the Money Mangers you are following
UserNotes=User Notes
MasterBrokerAccount=Master Broker Account
FollowUp=Follow Up
HaveFollowedUp=Have Followed Up
Text=Text
IsdefalutWarningMsg=Do you want to change default Price Markup Group ?
UserLots=Use lots
Lots=Lots:
ValLotVolume=Please enter lots.
LotSize=Lot Size:
VTLotSize=Lot size field cannot be left blank.
TradeLotsConfirmationInfo=Trade Confirmation: Type={0} {1} Lots={2} at Price={3}, Time={4}, Order ID={5}
InvalidLots=Invalid lots value.
CurrencyAmount=Amount(Currency)
AccountCurrency=Account Currency
UserNoteEdit=You have edited Note for this User.Do you want to continue?
PriceLots=Price*Lots
NeverAsk=Never Ask Again
Later=Later
InterestRates=Interest Rates
ImportInterest=Import Interest
InterestMarkup=Interest Markup
Widgets=Widgets
ReportsLive=Reports. Live Accounts
ReportsDemo=Reports. Demo Accounts
ShowPositions=Show Positions
HidePositions=Hide Positions
USDRevenue=USD Revenue
USDNegativePrice=Sell Value USD
USDPositivePrice=Buy Value USD
InterestRevenueTransaction =Interest Transaction Report
FeeRevenueTransaction=Fee Transaction Report
ActiveUsers=Active Users
LastActive=Last Active
LoginHistory=Login History
InternalTools=Internal Tools
RecalculateBalance=Recalculate Balance
ExitPrice=Exit Price
Entry=Entry
PointSize=Point Size
CreatedTime=Created Time
Amend=Amend
AmendOrder=Amend Order
ErrorLimitOrder=Your order will increase the position. Take profit and Stop Loss orders cannot increase the position.
LimitVolumeTooHigh=Your Take Profit and Stop Loss orders cannot have higher volume than your position.
InvalidOrder=Invalid order.
ErrorFollowMM=Could not follow Copy Trader Master, PFId={0}, On Account={1}, Error={2}
ErrorFollowPos=No trade made from Copy Trader Master, PFId={0}, On Account={1}, due to the account already has the position.
Maintance=Maintenance
MoveAmount=Transfer Amount
FromAccount=From Account:
ToAccount=To Account:
TransferAccounts=Transfer between Accounts
InvalidSelection=Invalid selection.
InvalidAmount=Invalid amount value.
AllReadyMerge=Account all ready merge.
DeletedAccountId=Delete AccountId
MergedAccountId=Merge AccountId
Created=Created
Merged=Merged
ErrorCode=Error Code
ErrorText=Error Text
MT4=MT4
MT4Sync=MT4 Sync
AccountDeleteConfirmationMsg=Account {0}:{1} will be merged with account {2}:{3}.{4}Then Account {5}:{6} will be deleted.{7}Are you sure?
AccountMarkDeleted=The merge will take place in the weekend.{0}Until then your account will be marked as "deleted".
DeletedEditAccountMsg=Account in delete mode. Edit is not allowed.
NoStrategyForRobotMsg=There are no Strategies defined.  You need a Strategy to create a Robot.
LogType=Log Type
AccountLog=Account Logs
EnumStatus= New#Send#Confirmed
EnumLogType= Unknown#New Order#Order Trade#Order Amended#Order Cancel#Account Added#Account Deleted
AccountLogClearMsg=You have successfully cleared all the previous account logs
CleanUpAccountLogKey=Clean Up Account Log
CleaningAccountLogMessage=Are you sure you want to delete all the Account logs older than {0}?
InvalidAccountCurencyMsg=Accounts has to be of same Currency.
InvalidAmountTransfer=Amount is low or accounts has to be of same Currency.
InvalidAccountTransfer=Account doesn't exist.
InvalidAmountExceedMargin=Amount is lower the balance amount or it exceed margin level.
InvalidMergeAccountMsg=Accounts has to be of same Currency or merge account has position.
InvalidMergeAccountDelete=Account is in delete process.
InvalidMergeAccountPos=Account {0}, has positions.
Layout=Layout
Trailing=Trailing
SelectLayout=Select Layout
SaveAsGlobal=Save As Global
SaveAsDefault=Save As Default
DeleteLayout=Delete Layout
MoreDataExists=You selected too many data. We have returned some of the data, {0} but you will have to narrow the search criteria to get a correct result.
AverageFifoMsg=Profit & Loss and the open-price of the positions are either calculated as an “Average” of the trades made on the account, or as “First In First Out” . Select which method should be used for this account.
Average=Average
Fifo=FIFO
SubBrokers=Sub-Brokers
AddAccountRight=You don't have rights to create an account.
GuestToTrade=Guest To Trade
PLMethod=PL Method:
DeleteDemoAccount=Delete Demo Account
ClearUserMsg=Are you sure you want to clear deleted users?
CleanUpUserKey=Clean Up Users
AllowManualTrading=Allow Manual Trading
AllowAccountView=Allow Account View
ShowContactInfo=Show Contact Info
TradesMoneyManager=Trades on Copy Trader Master
TradesFollowers=Trades on Followers
OrderHistoryFollowers=Order History On Followers
FromSymbol=From Symbol:
ToSymbol=To Symbol:
PortfolioFollowerReport=Portfolio Follower Report
DeleteAccountException=Account {0} is not deleted.
ContractSize=Contract Size 
PhoneNoInfo=Phone No
ContactInfo=Contact Info
Confirm=Confirm
ShowDemoOnLive=Show Demo Accounts, when running Live
TradingInWatchList=Open Trading window inside watchlist
AllowManualTradingConfirmation=You have chosen ‘Allow Manual Trading’ for the Copy Trader Master.{0}The Copy Trader Master can now submit orders and trade on your account.{1}Are you sure you will allow the Copy Trader Master to trade on your account ?
RightsAllowManualTrading=You do not have rights to trade on client accounts.{0}Please contact your broker and ask for rights to trade on client accounts
NoAccountInfo=You don't have any account.
VildateWebAddress=Please enter a vaild website Address
MergeAll=Merge All
DeleteALLAccount=Delete all with Success
Interval=Interval:
Graph=Graph
VaildBrokerMarkupValue=Please enter a vaild value greater than 0.1 or 0.0
PriceMarkupPips=Price Markup Pips
ReverseTrade=Reverse Trade
TradeReversal=Trade Reversal
TradeCorrection=Trade Correction
FIXIdTrade=FIX ID Trade
SignalLong=Robot={0} signals go Long on {1} at {2} Volume= {3}
SignalShort=Robot={0} signals go Short on {1} at {2} Volume= {3}
SignalNeutral=Robot={0} signals go Neutral on {1} at {2} Volume= {3}
TimeAgo=Time Ago
EnumNotificationType=Info#Warning#Error#Exception#MarginCall#StopOut#Trade#Rejected#DemoTrade#Signal
ClientOrigin=Client Origin
ClientOriginEnum=Unknown#SilverLight#API#MT4#Mobile#FIXMarket#FIXTrade#Other
LogTime=Log time
Counter=Counter
ServerLog=Server Log
OnlyLastLogin=Only Last Login
Logs=Logs
Queues=Queues
RightsMoneyManagerPublic=You are not allowed to share your Copy Trader Master to other users.{0}Please contact your broker to get permission to share your{1} Copy Trader Master
SLnTPisExit=SL and TP used as "Close Long/Short"
OffLineAt=Offline At
OnLineAt=Online At
Connection=Connection
ErrorAccount=Error Account
FridayClose=Friday Close
Sunday Open=Sunday Open
IncludeSubBroker=Include Sub Broker
FIXidColon=FIX ID:
TradeCorrectionMsg=This correction will generate a trade on Account={0}, UserId={1}, at {2} of Volume = {3} and a reverse trade on the brokers Error Account={4}. Are you sure?
ClientExposure=Client Exposure
FIXExposure=FIX Exposure
BankExposure=Bank Exposure
ToolboxMenuKey=Toolbox
CopyTrade=Copy Trade
MyCopyTraderMaster=My Copy Trader Master
SharedCopyTraderMasters=Shared Copy Trader Masters 
TradeStatistics=Trade Statistics
TradeStatisticsMoneyManager=Trades Statistics On MoneyManager
TradeStatisticsFollower=Trades Statistics On Follower
RecalFixTradeSum=Recalculate Fix trade sum
RecalFixTradeSumConfirmation=Are you sure you want to recalculate Fic trade sum? 
ErrorAccountUnavailable=Correction cannot be made. Correction account not present.
FillToNext=No Fill#Fill to 0 Line#Fill to next Graph#Fill to prev Graph
DebugOutput=Debug Output
LastMessage=Last Message
Reconnect=Reconnect
StrategyPrint=Show Strategy Print
StrategyPrintTitle=Strategy Print
ClearLog=Clear Log
BrokerAccountID=Broker Account ID
PriceCodes=Price Codes
ValidateCurrency=Please select a vaild currency !
OrderAcceptedConfirmation=Order received. Order ID ={0}. Straticator is awaiting confirmation and execution from the liquidity provider.
OrderRejected=Order Rejected. Order Id = {0}. Reason = {1}
SlipPage=Slippage
ExecSpeed=Execution Speed
Depth=Depth
BidPrice=Bid Price
AskPrice=Ask Price
BidOffset=Bid Offset(pips)
AskOffset=Ask Offset(pips)
AskVolume=Ask Volume
BidVolume=Bid Volume
LoginFailedMsg= We cannot connect to the server.{0} It can be because of no internet connection.{1} Please try to refresh your browser window.
OrderConfirmationDiff=You ordered {0}, but you only got {1} of {2}.
FIXUsers=FIX Users
EnumFIXSessionType=Both#Trade#Market
AddFIXUser=Add FIX User
EditFIXUser=Edit FIX User
FIXGroupId=FIX Group ID
FIXGroup=FIX Group
FallBackFIXGroupID=FallBack FIX Group ID
Enabled=Enabled
EditFIXGroup=Edit FIX Group
ADDFIXGroup=Add FIX Group
LiquidityPool=Liquidity Pool
Priority=Priority
SubSymbolId=SubSymbol ID
SymbolId=Symbol ID
SymbolType=Symbol Type
Effective=Effective
Settlement=Settlement
ExpireSalesPrice=Expire Sales Price
ExpirePurchasePrice=Expire Purchase Price
Collapse=Collapse
InputSearch=Input Search
AutoClose=Auto Close
EnumSubSymbolType=Future#NDF
Futures=Futures
InvalidPrice=Please Enter a vaild price Value
Settled=Settled
FixMsg=Fix-Messages
InvalidTimeframeOrderType=Expire = 'Time Frame' cannot be selected for this order type
TickSize=Tick Size  
Connections=Connections
ShowServerLogPopup=Pop up Warning with new messages
ServerLogNewMsg=New message has arrived in Server Log
OTO=OTO
TriggerOrder=Trigger Order
MasterSymbolId=Master Symbol ID
InvalidSubsymbol=Please enter a valid SubSymbol
LastOrder=Last Order
Rejected=Rejected
BankOrderId=Bank Order Id
LimitOrdersInFix=Limit Orders In FIX
VolumeNotInMultipleOfMinVolume=Volume has to be multiple of {0}
VolumeTooSmallWithParam=Minimum volume is {0}
AddOvernightInterest=Add overnight interest
Default=Default
Liquidity=Liquidity
CopyTraderMaster=Copy Trader Master
IndicatorId=Indicator ID
ExternalIndicator=Extrenal Indicator
AddExternalIndicator=Add External Indicator
SenderId=Sender ID
AddIndicatorValues=Add Indicator Values
ExternalIndicatorValues=External Indicator Values
ErrorInScript=Could not start robot, since the robot has compile errors in the script in the Strategy.
ChoiceLiquidity=Choice Liquidity
Trade%=Trade in %:
NumberofContracts=Number of Contracts
FIXSessionID=FIX Session ID
NoActiveLiveAccount=You don't have active live account
UserRights=User Rights:
FIXLog=FIX Log
LGIdWeekend=LGId Weekend
LGIdSymbol=LGId Symbol
FIXLogValues=None#Selected#All
UseOwnThread=Use Own Thread 
ListenBeforeProcessing=Listen Before Processing
HasOwnLiquidity=Has Own Liquidity
DepthSize=Depth Size
PriceFIXGroupId=Price FIX Group ID  
DynamicDepth=Dynamic Depth
RobotStopped=Robot '{0}' has been stopped. Reason={1}
ValidateBrokerID=Broker ID can not left blank.
ValidateChangePassword=Change password is not allowed for this user.
PopupNotifications=Popup Notifications
NotificationsMessage=You have new message in ‘Notifications’
EditFollower=Edit Follower
SettingsMsg=Your theme has been changed and will be effective from your next login.
AccountsBalance=Accounts Balance
BrokerMarkupRevenue=Broker Markup Revenue
TradeRevenue=Client Markup Revenue
TotalExposure=Total Positions
NoConversion=No Conversion
BlueTheme=Blue Theme
DepositConfirmation=Deposit Confirmation
ChangedOn=Changed On
ChangedBy=Changed By
PasswordReport=Password Report
Symbol=Symbol :
OrderID=Order ID
Symbolkey=Symbol
Time=Time
Price=Price:

UserNameKey=User Name
PasswordKey=Password
Cancel=Cancel
Login=Login
MarketPriceKey=Watchlist
FromDate=From Date:
ToDate=To Date:
Search=Search
Reports=Reports
Orders=Orders
MPSell=SELL
MPBuy=BUY
MPVolume=Volume
MPType=Order Type:
Expiry=Expiry
HTakeProfit=Take Profit
HStopLoss=Stop Loss
TrailingStop=Trailing Stop:
ManualOrdersKey=Orders
TradesKey=Trades
SelectaccountKey=Select Account
OrderHistoryKey=Order History
CurrencyExposureKey=Currency Exposure
SymbolCollectionKey=Symbols
AllKey=all
NoneKey=none
MySettingKey=My Settings
ShowAll===--Show All--
MPClose=Close
OrderStepKey=Order Step
PrDate=Per Date
currency=Currency
Amount=Amount
AmountUSD=Amount USD
MPSymbol=Symbol:
MPPrice=Price:
Volume=Volume:
MPTrack=Track:
OrderType=Order Type
Type=Type
Ask=Ask
Bid=Bid
Spread=Spread
ChartKey=Tick Chart
HOpenPrice=Open Price
SymbolExposureKey=Symbol Exposure
InputNumOf=Number Of:
ClosePosition=Close Position
PFid=PFID
PFidKey=PFID:
AccountNo=Account No
Edit=Edit
Save=Save

Transactions=Transactions
LIVETRADINGACCOUNT=LIVE TRADING ACCOUNT
ForgotPassword=Forgot Password
LoginKey=Login
cancelKey=Cancel
PositionsKey=Positions
CurrentPriceKey=Cur. Price
Watchlist=Watchlist
ReportsKey=Reports
Searchkey=search
OrderstitleKey=Orders
EURKey=EUR
TradestitleKey=Trades
USDKey=USD
Pricekey=Price
amountkey=amount
curAmount=amount curr.
orderticketKey=order ticket
savehidekey=save & hide
NoResponse=No Response
OrderNoResponseMsg=No response from server.{0}Please check your Order history.
GoOrderHistory=Go to Order History
ClosePositionConfirmation=Are you sure you want to close position "{0}" of "{1}"?
Confirmation=Confirmation
Invested=Invested
MarginUsedAmt=Margin Used
CancelOrderConfirmation=Are you sure you want to cancel order "{0}" ?
OrderCancelledkey=Order Cancelled.
AccountId=Account Id:
OdrId =Order Id: 
CreatedTimekey=Created Time:
SLKey=S/L:
TPKey=T/P:
ExpiryKey=Expiry:
OrderOriginKey=Order Origin:
ActionKey=Action:
Tmkey=Time:
OriginOrder=Origin Order Id:
RelatedOrderId=Related Order Id:
OrderDetails=Order Details
TrailingKey=Trailing:
OTOKey=OTO:
SecondKey=Second:
AmountCurr=Amount({0}):
AmntKey=Amount:
NoConnection=Internet connection is not available.{0} Trying to connect...
ConnectionAvail=Internet connection is available. You can login now.
PageLoadMSG=Loading your settings
OrderProcessing=Order Processing
ZoomIn=ZoomIn
ZoomOut=ZoomOut
SecKey=Sec
MinKey=min
hrsKey=hrs
Details=details
Trackkey=track
ErrorClosePosition=You cannot close this position of {0}. Please close the position above first.
TradingRobot=Trading Robot
RobotTrade=Robot Trade
PauseRobot=Pause Robot
On=On
Off=Off
Loading=Loading...
PLInterval=1 Hour#4 Hours # 1 Day
OrderInProcess=Order is being processed
ValStopLoss=Stop Loss is too close to price.
OpenTime=Open Time
PositionId= Position Id
ExchangeName=Exchange:
Stocks=Stocks
OrganizeKey=Organize
GameLogin=Register for stock game
InvalidMinimumFollow= Minimum amount to follow cannot be less than {0}.
Typekey=Type
LIVETRADINGACCOUNT=Live Trading Account
AccountManagerError =Operation cannot be completed. Only one CTM per Account is allowed. Create new account in Straticator under My Account/Accounts/Maintenance/Create Account or contact Support@npinvestor.com.
StopFollowingMessage = Are you sure you want to stop following?
EditAccountMsg = Please select account before editing.
MinAmountKey = Min Amount
Register=Register
ValidationErrorRequiredField= field is required
ValidationErrorBadPasswordLength= Password must be at least 7 and at most 30 characters long
ValidationErrorBadPasswordStrength = A password needs to contain at least one special character e.g. @ or #
ValidationErrorPasswordConfirmationMismatch = Passwords do not match
BecomeCustomer = Become a client
True= True
Flase = False